回溯时光长廊，赴创意之约。@路易威登@	 从过去获取记忆的灵感，创造明天未知的潮流。沿着飞行、航行、旅行的踪迹，一只只重新开启的老皮箱带我们重塑时代的美、创新与前卫精神，也陪伴更多探险者踏上前方的新乐园。@路易威登@ 
7月22，说走咱就走！@唐德影视@:7月22日，来一场说走就走的“绝地逃亡”，你准备好了吗？	 你有多久没看过龙氏喜剧动作片了？电影曝定档海报预告拳笑归来，期待值up up ！@成龙@ 大哥英雄力MAX，从头打到尾；@范冰冰@ 美艳登场，实力撩汉；好莱坞男星约翰尼•诺克斯维尔逗比搞笑，贱贱惹人爱！7月22日，来一场说走就走的“绝地逃亡”，你准备好了吗？预告猛戳： ...
美好的一天，速度与激情@范冰冰工作室@:燃起挑战极限的热情！超越速度，超越自我！	颜值与激情一个都不能少！作为全球首位将名字印于F1赛车上的女明星，范冰冰今日一袭优雅黑裙出现在雷诺车队维修区。看赛车的同时，更“偶遇”雷诺小鲜肉车手合影留念。范冰冰名字与F1赛车的合体，是雷诺全球“LetsRaceTogether”主题活动的重要部分，意在用跨界的方 ...
一同迎战@范冰冰工作室@:激情不止于赛道！向新挑战进发！	雷诺F1王者再临，明日即将挥戈一战！而范冰冰中文名首次与R.S.16战车合体，见证又一个速度传奇！@范冰冰@@范冰冰工作室@ 
感恩第七年，我们继续努力！@陈砺志@:七年前跟冰冰描述这个项目的时候,只是想完成当时60多个孩子的手术就好了,没想到一做就是七年:20000多个孩子的筛查体检,204个孩子和204个家长陪同在北京上海的手术,其中无数例惊心动魄的高难度手术和重症监护室的抢救等待。谢谢冰冰的爱心,一路走来,与有荣焉！	迈入第七年，在澳大利亚总理夫人Lucy Turnbull女士的见证下，澳洲BLACKMORES向“爱里的心”捐赠人民币三百万元，为爱助力！范冰冰、陈砺志、刘正琛代表项目接受了现场捐赠。七年，我们在行动，未来，愿看到更多孩子的笑脸。 
我也要女力觉醒了！	《》今天上映，看了不下二十次、每次都又哭又笑！希望大家能够喜欢，并找到最初的自己！闺蜜不仅可以一起买包包、聊八卦；还可以一起创业！笑泪有时，女力觉醒！@电影梦想合伙人@ 
恭喜东田！加油！	非常感谢众多好友来参加我们的上市答谢晚宴，帅哥美女云集，好美的夜晚！爱你们我亲爱的朋友！有你们在太开心啦，美的欢乐时光，新朋老友相聚北京，大家对我们的支持一直是我们前进的动力！@吕燕@ @范冰冰@ @尚雯婕@ @小陶虹@ @TIA袁娅维@ @刘力扬JenoLiu@ @李威Leewei@ @万荧女_万宝宝@ @Johnny黄景瑜@ @李静@ 
大家记得4月29日进影院，支持心如的《魔宫魅影》哦！	特別特別開心我的兩個從小一起成長的好朋友，百忙之中來支持我的首映礼！我只能說，歲月靜好，友情無價～愛你們@范冰冰@ @蘇有朋@ 
有意思！	【揭露女人思考的秘密！】台湾中央大学认知神经科学研究所所长洪兰教授讲述脑科学揭露女人思考的秘密！有数据、有感性，有理有据，幽默吸引人。现场超赞，笑点不断，非常涨姿势，时间较长。先转藏再看by网络 http:t.cn/Rq90Erd 
是的，按照你想要的方式，过成无可取代的样子	  有人喜欢你，有人讨厌你；有人给你贴上标签，有人对你嗤之以鼻。以前碰到摩擦会反驳，如今发现偏见远比想象的更根深蒂固。委屈自然有，难过也会在，不被理解更是常事。不需要太多解释，言语无法改变任何人的看法。选择一种生活方式，按照你想要的方式过成无可取代的样子 
允儿，很高兴认识你！	在工作现场见到@范冰冰@ 姐姐了！见到你很高兴～  
陆垚知马俐 支持！	 路遥知马力，日久见人心。久违的@文章同學@ 两年潜心创作，全新导演作品 正式进军暑期档！“一根筋”的小坚持，“一句话”的小感动，爱情中的反复纠结和拉锯，看@包贝尔@@宋佳@@朱亚文@@焦俊艳@ 如何演绎“友情不甘恋人不敢”。< 
原来你是这样的国宝	【真的好羡慕饲养员啊】明明是滑滑梯，最后却玩出了保龄球的感觉，圆滚滚们果真是出生即带萌属性啊！原来你是这样的国宝，你们要的大熊猫 by网络 < 
7月29 暑期见	 海报来也！大家一起数星星→@李连杰@ @范冰冰@ @黄晓明@ @angelababy@ @古天乐@ @文章同学@ @向佐JackyHeung@ 梁家辉 祖峰 @安志杰AndyOn@ @许晴随行笔记@ @陳小春@ 众神归位！请用一个词点评本片阵容，评论里最有才的那位，片方将免费送你去上影节“全明星封神之夜”哟！ 
冰雪奇源	 范冰冰、王源为《时尚COSMO》6月刊拍摄的双人大片曝光，暗黑女王与青涩少年的“冰雪奇源”，摄影：@陈漫ChenMan@ 。 
大家好，爵迹战队来啦！导演，父亲节什么的一定是因为队里有一只郭霸霸@郭敬明@:大家好！我们是高颜值的爵迹战队！（疑？好像有个颜值不太高的导演混进去了）不过，为什么我的那本封面要搭上“父亲节特别企划”呢.......小编你出来我们聊一聊好吗......	???? ????<br/>奥汀8子集齐，6月刊召唤成功！@William威廉陈伟霆@ 、@陈学冬@ 、@范冰冰@ 、@郭采洁@ 、@郭敬明@ 、@林允Jelly@ 、@李治廷@ 及@TFBOYS-王源@ 携手呈现双封面！明天起将每天揭晓2位主创的网络专属单人封面，更有可能获得独属你家偶像的签名海报套装，敬请锁定陆续开启的购买链接 ...
母亲节，带着妈妈看一场《百鸟朝凤》。朴实、温厚的故事，平淡却饱含深情。祝每一位母亲节日快乐！	既然无法回到她的青春陪她看一场经典的露天电影，那就今天拉着她去趟影院，重温她意犹未尽的电影老时代。百鸟朝凤，时代杰作，和妈妈一起哭，又一起笑@方励@ @吴妍妍@  @李睿珺film@ @陶泽如的微博@ @Mr__小李子@ @演员胡先煦@ < 
为什么触碰我的底线，为什么要这样折磨不白会死星人！哈哈哈哈哈	冰冰变黑后你还喜欢吗？@冰冰晨报官博@  
支持呢！现在去电影院的路上了！	第一次这样“不顾廉耻”的刷屏吆喝新戏，搞得朋友还以为我有投资…这个，真没有。导演和制片人都是第一次拍电影，态度认真恭谦。作为主演，理应努力演戏，尽力宣传，做好所有的本分。感谢每一位亲朋好友的支持，情谊记心上！圈内有句俗话：一部戏有一部戏的命。愿这部电影好运。????@电影梦想合伙人@ 
第七年，爱里的心@陈砺志@:终于有了 官方的家，明天早上 团队就又要从北京、上海、深圳出发，在拉萨会合，开始第七年的项目筛查之旅。	有了自己的家， 
都早点下班去过节！	出大事了!520公司每个同事都被老板表白了我们是不是应该回应她一个热烈的么么哒？怎么办，在线等，挺急的！ 
能听到难过的不要不要的，就应该是好情歌吧！@薛之谦@	薛之谦《你还要我怎样》官方版，很适合一个人安静时候听，最后一段，听哭了 < 
不遗漏每一个孩子，不放弃每一丝希望！都值得了@陈砺志@: 看到达娃卓玛，没能忍住眼泪，六年前决定去把放羊的她接回来检查，一个下意识的决定给了她新的生命机会。如今她健康，还做了妈妈，还坚持搭便车来县里给自己孩子做先心病检查……所有这些，再苦再累，我们都觉得值了！	2010年我们到改则县筛查，返程路过麻米乡，与计划筛查60多个孩子有2个孩子没来，一个放羊去了一个感冒在家。当时决定，不能遗漏，我们派车到牧区放羊的地方，把这两个孩子追了回来，全部确诊。图中女孩达瓦卓玛，当时16岁，肺动脉高压接近120，属于高危，被 第一批送到北京救治，她不仅重获 ...
提前祝小姑娘手术成功，早日康复那样也就不负此行了。@陈砺志@:每一例手术可以挽救一个孩子的生命，这是我们坚持七年的动力，也是 这个项目的价值和意义。	 图中是措勤县的一对小夫妻，女儿四岁，确诊先天性心脏病，肺动脉高压数据已经偏高危，需要安排在今年第一批去上海手术，否则有生命危险。 的价值在于，发现一例立即安排手术，一劳永逸不再复发，一个生命得到挽救。小姑娘美美哒，很幸运，我们也提前祝福她手术顺利！ 
看了这条，感动哭！你们这么辛苦，是值得的！	公路限速 拼命跑到现在还有370公里 预计7点到措勤。吃碗午饭继续赶路 藏区的土豆巨好吃。刚刚和当地老百姓聊天，得知 第一批治愈的孩子已经结婚生子了，他们说“范冰冰做的这件事就是活菩萨。”感恩。能参与助人， 于我们，何尝不是一种福分呢 
大家都辛苦了！加油！@范冰冰工作室@:明天继续加油希望大家状况都好转 @陈砺志@:说实话,团队成员太让人感动,敬佩。昨天拉萨,今天措勤,并不是合理安排,但每个人都有自己的工作,都需要抢时间。今天狂飙890公里已属不易,下车伊始就工作更是挑战。希望今晚所有高反症状缓解,明天四个乡下全是土路！	 第一站筛查顺利结束，共确诊4个孩子，我们回程后会尽快与家长联系，安排手术事宜 
揪心！前方的同学们坚持住！@陈砺志@:终于到了！14.5个小时，下车没有休息，已经开始工作了。高原反应确实是一个感同身受的事情，没经历过的无法从语言和文字里去感知，总之每年一趟都是艰苦焦躁难受但又会坚持做下去的事情。	3年前走这条路，开了21个小时，一路爆胎，13个队员挂掉12个。今车速一直上不来，比原计划晚了两个小时，一路上不断有队员挂掉，刚队长挨个给测数据：初次进藏的@老缺先生@ 血氧68，心跳54！赶紧上氧气！二次进藏的@YANG8810@ 昨天凌晨开始一直在吐，现在小威旁边昏睡 
女人的优雅从来都与年岁无关，祝雪姐«优雅»大卖！	《优雅》修订版面世，加了“女人四十”一章。人生有些道理，都藏在岁月的针脚，过一年，明理明事多一点。也怕老，所以三十以后努力和年龄成为最好的朋友。人相遇，字相见，有缘分享，是彼此的福气。当当<亚马逊<京东< 视频< 
没事，我还在。@冰冰晨报官博@:  看的莫名心酸 @范冰冰工作室@:我们了解慈善的不易，清楚肩负的期望，坚持下去却能看到更多光亮。为每一份期望，尽力。祝福每一个为公益事业贡献过力量的人。	今天收到一封辞职信，公益部门员工。算下来从2009年麦特文化公益部门成立至今，这是第五个离职员工，还有一个怪圈：公司所有去过西藏阿里做公益近十个员工几乎全离职。做公益其实很难，需要帮助的人太多，每一个家庭背后都是血泪，每拒绝一个需要帮助的人都是痛苦…我们走得很沉重，但还会坚持走下去。 
妖，妖，切克闹！白胡子老头儿抓不到！	约架啦约架啦～封神剧透社最新发布美图，反方代表妲己娘娘@范冰冰@ 零距离喊话正方代表子牙大叔@李连杰@ ，双方正邪对峙3秒后相约三天后各携精锐战将齐聚上海电影节! “封神之夜”～欢迎持续围观  
生日快乐！青年电影手册越办越好！	明天6月6日是我生日，请关注卫星dianyingshouce66   谢谢一直以来支持青年电影手册的每位艺术家，我也将继续关注和支持你们的优秀艺术作品！@郝蕾@ @郭富城@ @王宝强@ @陈思诚@ @徐峥@@秦海璐@  @董冬咚d@ @黄璐lulu@ @春夏_x@ @小美ceo@ @谭维维@ @王铮亮@ 
第一期21:10就要播出了，提前给你们个眼神，随意感受一下！	来了盟盟家都一样，也难逃表情包 
对这些孩子来说最好的礼物是健康，祝福	对于大部分的孩子来说，六一想要和父母去游乐园玩耍，想吃蛋糕，想要好多礼物。可还有一些孩子，对于他们来说六一最好的礼物是健康。范冰冰发起的能够坚持多年去西藏进行救治让孩子们重获健康，十分不易！愿孩子们手术顺利！！ 
祝福孩子们，六一快乐！@陈砺志@: 本次筛查在阿里地区七天总行程2550公里，筛查2940例，确诊42例先天性心脏病手术对象。6月20日，阿里红会2名工作人员将带着42个孩子➕42位家长的浩荡队伍从阿里到上海远大心胸医院手术！明年再见，西藏阿里！祝福孩子，未来手术顺利	海拔、高山、土路、高反都将离开，但爱我们希望留下 走过四县十三个学校，筛查2940人（包括周边乡民），确诊42例。6月20日，孩子们将启程上海进行治疗 
我们   的清洁空气。	［联合国会客厅］去年5月，一条“我们”体微博，让跑男@李晨@ 与联合国微博有了第一次亲密接触。一年后的今天，李晨在联合国环境署总部内罗毕举行的世界环境大会上启动了“跑蓝计划”，并做客联合国会客厅，跟我们分享他在环境大会上的见闻与收获，以及有关“我们”的最新进展！< 
上天下地，妖风起！	 首款高清预告到货，请验货！< 众神归位，再造传奇，这个暑假，跟@李连杰@ @范冰冰@ @黄晓明@ @angelababy@ @古天乐@ @文章同學@ @向佐JackyHeung@   @安志杰AndyOn@ @许晴随行笔记@ 一起上天入地！ 
演员小四，欢迎期待@郭敬明@:一年多的时间，都待在后期棚里，反复雕刻每一个画面，希望能配得上大家的期待。而且，毕竟是我的第一部演员银幕作品，也是有点腻害。预告片里，你看到我了吗？	 电影《爵迹》发布首款全长预告片，鬼山莲泉、银尘、特蕾娅、神音、麒零等集体上线，王爵和使徒相爱相杀，“再渺小的希望，在绝望面前，都有无限大的可能”……< 
同学，你的快递到了！	您有一件物流单，请查收。本周六晚21:10看@范冰冰@ 化身“物流特工”，挑战”偷天“任务，击破一切阻碍！ 
今天还没时间吃饭，晚上还有两个发布会一会儿见	冰冰身着Delpozo2016春夏系列花朵刺绣晚礼服出席上海电影节开幕式，服装师@闵塔鲨@  妆发师@张浩然R-studio@  小编我就是来把高清美图搬运给你们而已！还有还有小胖参演的《爵迹》、《绝地逃亡》、《封神传奇》这三部影片都将在上海电影节陆续亮相哦！ 
当捍卫已久的忠诚变成错误时，剩下可以让我们继续相信的是什么？是我们彼此誓死捍卫的不离不弃。万千幻象，与你共燃！	【爵迹首支预告片发布】重要提示：1.请把手机或电脑荧幕亮度调到最亮，画面以影院最终效果进行调光调色。2.请务必手动将画质选择为“高清”或“超清”。3.请把音量开足，有耳机的话强烈推荐戴上耳机。4.在电影院大银幕看过预告片的同学，可以对比下效果。5.来，引爆吧！  ...
让你笑到流泪！????????????7月22，准备好了吗？先戳视频“防狼特辑”姑娘们都看看！	 绝地五美齐聚上海，女星负责动作到家，成龙负责喜剧如花，7月22日，看不一样的成龙动作喜剧范。八张角色海报，成龙表情包惊艳全场，全明星阵容首度亮相，还顺手曝光两款制作特辑，就是这么壕！看猛戳< 看女星动作到家猛戳< @成龙@  ...
我uncle送的！@李晨@ 接招！@成龙@:送给冰冰防狼用的，我为侄女也是操碎了心！@范冰冰@	龙叔@成龙@ 送给侄女冰冰@范冰冰@ 的防狼铁扇，冰冰秒变铁扇公主，这是要对付谁？ 
喜欢 服装@闵塔鲨@ 化妆@张浩然R-studio@ 摄影@七明多@	范冰冰. 皇家加勒比“海洋赞礼号”首航庆典. Luisa Beccaria 2016秋冬系列. Styling by 闵锐????. 
东方阿宝，西方阿瓜，惊险逃亡，爆笑暑期	“惊喜若狂”版海报预告爆笑来袭！[江南style]三角形海报活久见，成龙呆萌，约翰尼·诺克斯维尔、范冰冰都盯着成龙，莫非有什么暗示？不过预告中两位好基友，东方阿宝@成龙@ 、西方阿瓜约翰尼·诺克斯维尔，也是为了营救@范冰冰@ ，踏上逃亡之路。期间惊险不断，爆笑连连！戳→_→  ...
睡觉了，梦里见吧	 回顾| 2003年萍踪侠影/ 芸蕾 
这里真的美美的	范冰冰与涵碧楼酒店集团董事长赖正镒一起放归了鱼苗。大波美照~~ 
谁手里还没几张这种照片？谢依霖，还hold住吗？ <	把自己變美也許很難，但把別人變醜卻很容易????這種照片既然進到我手裡，我是一定會發的@范冰冰@  挑盟雙姝 
老爸这大长腿太逆天了！我是不是搞错重点了二位唱得好！(此处应有掌声????????????	范冰冰爸爸范涛再亮歌喉喽，助力好友李进，二人在CCTV3《非常星发布》合唱一曲《你最近在干吗》，大家觉得二位蜀黍唱得总么样？ < . 
Mr Cat他心里在想：总有刁民想害朕！	什么时候开始的，不得而知，总之是垂帘听政了。 
吃瓜群众已搬好小板凳????????????@李晨@:今晚第四季最后一集，来吧，兄弟！	【 今晚收官！】 今晚21:10燃起来！没有好队名怎么行？@邓超@&amp;@岳云鹏@ 、@angelababy@ &amp;@向佐JackyHeung@ 、@李晨@ &amp;@演员乔杉@ 、@陈赫@ &amp;@张静初@ 、@郑恺@ &amp;@王子文Olivia@ 、@王祖藍@ &amp;@黑人建州@ 、@M鹿M@ &amp;@华晨宇yu@ 七组跑男蓄势待发，求队名，求脑洞！ 
你还记得小时候，你想要成为一个什么样的女孩儿吗？Girl Power	 这么多年，@范冰冰@ 心里一直住着一个“不撞南墙不回头”的小女孩，这个女孩演戏、谈恋爱、做公益……从不疲倦，从不抱怨：“撞了墙，知道疼的时候，才想起没有听劝。但是我也不后悔，人生就是这样，不知道、知道、不明白、明白。不管是好的与不好的，你回过头来看的时候，它都是美好的。” ...
《爵迹》燃夏，惬意生活	《时尚健康》16周年惊喜最终蛋：@陈漫ChenMan@ 掌镜，@范冰冰@ @陈学冬@ 夏日海滩旅行珍藏版封面大片全景呈现。有欧洲杯和奥运会陪伴的2016之夏，和范冰冰、陈学冬 一起，惬意生活 < 
好朋友们的合作，依然默契愉快	秀发如云，眼波如水，每次见到她的地方，人烟里远远地便看得到，像是一枚寒星或一轮艳阳。纵然荆钗布裙，也是难掩光彩。@范冰冰@ 是一个标准，是一杆尺。做女演员，难道不就应该做到这个样子？ 既然是女演员，谁要泯然众人般的存在感。 编辑：@张晶LOFFICIEL@ ；摄影：@柳宗源@ ；采访、文：张瑰宝 ；化妆 ...
@范冰冰工作室@:范冰冰身穿Alexis Mabille 2016春夏高定礼服出席游戏代言活动，高清美图来啦，快快转走私藏吧！Styling by 闵锐@闵塔鲨@ 妆发@胡議尹@ 摄影@七明多@	范冰冰.《暗黑黎明2》全球战略发布会 暨中国首发启动仪式 . Styling by @闵塔鲨@ 
很荣幸公益项目获得这个荣誉，感谢新浪@微公益@ 一直以来对“爱里的心”的支持，感谢大家对孩子们的关心，今年我们的35名患儿已抵达上海，准备接受治疗，不久后他们将带着健康的心脏回家。@陈砺志@	6月28日，由@微公益@ 及多家传播机构联合发起的“微博社会化公益传播联盟”在北京成立。同日，第二届成功举办。全球200多家公益机构及知名明星、权威媒体、责任企业代表，以“分享、普及、交流”的专业态度探讨公益传播发展趋势，交流公益传播的“新产品、新模式、新思路”。女神 ...
我也会！生日快乐！可爱的冬冬	又到了628这个日子，时间走得好快，一转眼认识你已经这么多年。看着你从一个普普通通的大学生，到现在越来越进步越来越获得更多人的认可与喝彩，真心为你感到高兴。未来的你，一定会越来越好，你永远都是闪亮的小小星辰，而我也会一直在你左右。冬冬，生日快乐！@陈学冬@ 
孩子们，期待看到你们最美的笑脸！辛苦了“爱里的心”各位同事们！	 第19批孩子来啦！今天35名需要手术的宝贝们顺利抵达@上海远大心胸医院@  休息调整后，孩子们将开始陆续接受术前检查和手术安排。长途跋涉的路程，他们的状态都还不错，也有些兴奋。一次带着35个孩子和34名家长的大部队前来，辛苦阿里红十字会的格桑珠杰和次央两位带队同事 
下面请历史课代表李晨同学发言	李晨，一个大写的直男 
干杯，盟友们！	一杯葡萄酒，呛得眼泪流？爱笑的@范冰冰@ 运气不会差，任何“陷阱”都能自动绕道。本周六20：30看酒庄时尚icon玩心大起，任性“发福利”！ 
为2位领队格桑、次央点赞！@陈砺志@:不可能完成的任务，格桑珠杰已经干了七年，走了19趟这样的行程！ @小黄少@:2人带69人的队伍，小孩闹腾、家长语言不通、第一次出远门的兴奋、折腾了18天安全抵达，简直不可能完成的任务[群体围观]太不容易了！	35个孩子➕34名家长， 阿里→拉萨→上海，孩子们从各县区集合到抵达医院，共18天，辛苦阿里红十字会的格桑珠杰和次仁永西2人带69人的庞大队伍。大家一起来看看这18天的路途。 
致敬，人民子弟兵！愿平安！希望快点雨过天晴	【致敬！抗洪抢险中，那些无所畏惧、最可爱的人】大雨滂沱，他们来不及穿雨衣；为运沙袋，他们浑身是泥，里外湿透；混着雨水的瓶装水和几个馒头，就是他们日常伙食……近日，我国多地出现洪涝灾害，哪里有危险，哪里就有他们的身影。致敬，人民子弟兵！愿平安！（图/网络、视觉中国） 
不惧时间流逝，不怕风雨来袭！Girl Power！	 她拥有所有女孩儿想成为的模样，更拥有一颗不惧怕时间流逝的强大内心， @范冰冰@  告诉我们她心目中的 “Girl Power”。 “你还记得小时候，你想成为一个什么样的女孩吗？”对于冰冰的提问，你们的回答是什么呢？   
你的重要时刻，加油！我们都在！	我的重要時刻，我想見你們。 
保护家人！	No one should ever walk near this line! Do what you desire to me, I’m indifferent. But never cross the line of FAMILY! Never!!! 
已转告冯导，那就先来一声惊叹给我们听听呗@薛之谦@:我最擅长的就是毛遂自荐... 我最出名的就是不要脸面... 那问题就来了...敢问 @范冰冰@   贵剧缺主题曲吗.. 插曲也行...哪怕是一声惊叹...我也愿意.. 麻烦转告冯导..告诉他我自强不息...活好不粘人...也不是很在意钱...主要是想交个朋友.	预告片首发！李雪莲有话说，她不是潘金莲！< 
可惜火锅都没吃上就奔机场了！ 谢谢成都的热情！还有我的冰邦！????	《绝地逃亡》第三站 成都的朋友们太热情啦！服装 @闵塔鲨@ Prabal Gurung Pre-Fall 2016 妆发 @张浩然R-studio@ 摄影 @老缺先生@ 
哇！可爱哟！我的小狮子！	有人非要给它置办一双雪地靴，拦都拦不住不过这下倒是凉快了，妈妈再也不用担心它长痱子了。 
这个女人我看了都害怕，她会吃人吗	 是霸气的高贵女王，是凶狠的蛇蝎美人，一心要统治天下的她，要铲除所有阻碍她道路的人，她，是苏妲己，@范冰冰@ 苏妲己版预告来袭：<  7月29日，上天入地，各显神通！ 
收到了最美的画，听到了最好听的歌，看到了最纯真的你们。孩子，谢谢你们，我们会一直一直走下去。@陈砺志@:第二次获得代表家长和孩子心意的黄哈达，一边是感动和责任，一边是诚惶诚恐，我们会坚持，努力，一直走下去。	 冰冰和陈总来看小朋友啦！今天@范冰冰@ @陈砺志@ 特地赶到上海远大心胸医院来看望手术成功的34个宝贝。孩子们看到他们现场就唱起了最爱的藏语儿歌《格桑花》，并把精心图绘的儿童画送给他们，家长们也送来了唐卡感谢信表示感谢。看到宝贝们身体都恢复的这么好，是我们最欣慰的事。 
观影前一定要看的福利贴！祝《寒战2》票房大卖！	中“铂金洗印法”、“四重身份”、“暗房”、“枪械专家”这些泥萌都知道嘛？嫑方，贴心的寒叔已经整理好了【《寒战2 》你不知道的26件事】观影前一定要看哦！憋怪寒叔没有提醒你【淘票票】< 【百度糯米】< 【猫眼】<【微票 ...
毫无违和感的刘苹果与纪春生	当范冰冰和葛优一起瘫倒在沙发上，这画风 
谢谢！	谢谢！尊重事实，报道真相，是新闻媒体高度社会责任感的应有体现。我们希望这样的“博眼球”不再有！ 
@陈燕丽Carrie@ @你好我姓白@ @李彤_KiKi@ @_P先生_@，还有@新浪娱乐@ 选出的@Flora-祝范小胖永远幸福@ ，你们就是5000万福利的幸运小伙伴！即将开机，准备好一起来剧组找我玩儿吧！我的同事会和你们联系哟	5000万粉丝来点特别的福利！我将随机抽取5位转发本微博的朋友，邀请你来剧组和我一起拍戏。机票、酒店等一切费用都由画右这位先生买单，邀请你来剧组体验一天，晚上我们再一起晚餐，来玩吗？ 
再过5个小时就上映啦，听大哥的话，好笑你就多笑会儿，好看一定要分享哦	大哥说：好笑就多发朋友圈！全国上映，好笑你就多笑会儿<<br/>淘票票：<br/><<br/>百度糯米：<br/><<br/>猫眼电影：<br/><<br/>微票儿：<br/><  <
刚哥，没别的，我就是高兴！	拍摄前我对@范冰冰@ 说，这角色不讨好也不要搏同情，不能往漂亮化妆，没有特写和近景，拍的戏可能有一半要剪掉，失败的风险也很大，拍摄预计三个月不能请假，每场戏需要事先排练，也没有预算付你高片酬，拍摄完成前不会有媒体探班和宣传。你接受吗？她沒有片刻的迟疑爽快的回答我，行！她做到了。 
@范冰冰工作室@:“长得漂亮的人挺多的，大家都可以靠脸吃饭，为什么没有人成为范冰冰？没有人可以不劳而获，没有人可以不经过努力，不经过成长，不经过疼痛就收获所有。”——范冰冰	没想到，聊下来我们发现，最会接地气的人，竟然是@范冰冰@ ！@电影我不是潘金莲@ < 
7月21，大家记得去看《绝地逃亡》哦！	今天绝地逃亡家族集体“逃亡”到北京啦！主持人问到每个人心中对成龙大哥的印象，冰冰的第一反应就是&quot;太阳”，像太阳一样温暖，把欢乐带给大家！7·21等着与大家见面，拳笑归来，给你快乐！服装@闵塔鲨@ 化妆@胡議尹@ 摄影@高宇勋@ 
这才是中国，一点都不能少。	这才是中国，一点都不能少。 
捷报传来，首周末破四亿！说话算数，转发中我选五位朋友，送每人两张电影票。再多选一位，送出我签名的羊驼公仔。这次会选中谁呢	 小逃君票房播报：首周末破4亿！4亿！4亿！ 成龙电影开画周末最高纪录！这个暑假，全家老小一起看成龙电影笑笑笑不完～ 
 期待上映	范冰冰身穿Ralph &amp; Russo 2016秋冬高级定制礼服，出席封神大典，大家准备好观影了吗？服装：@闵塔鲨@ 妆发：@胡議尹@ 摄影：@七明多@ 
@iurekuy@ @一只冰邦是溪水@ @沫潇汐-冰冰棒@ @刘秋宏阿@ @杨双儿要快乐@ 你们准备好去看电影了吗？@小彤_721绝地逃亡@ 羊驼公仔是你的啦！@范冰冰@:三天破三亿啦！转发中我选五位朋友，送每人两张电影票。这次再多选一位，送出我签名的羊驼公仔	 三天三亿！三天三亿！最强合家欢，娱乐性十足，让你笑个够～ps：小逃君这次要绕操场跑20圈～ 
三天破三亿啦！转发中我选五位朋友，送每人两张电影票。这次再多选一位，送出我签名的羊驼公仔	 三天三亿！三天三亿！最强合家欢，娱乐性十足，让你笑个够～ps：小逃君这次要绕操场跑20圈～ 
@空白爱吃冰@ @溜达的屁颠的@ @豪华牛奶@ @最爱范小胖的格格@ @月落夕阳升@  请留意@范冰冰工作室@ 微博私信哦两亿的幸运影票来啦，三亿的也不远啦! @范冰冰@:破两亿啦！我从转发中看看选哪五位朋友，送你们每人两张电影票。破三亿开始我要想想多送点啥	 小逃君报道：票房已突破2亿，快带上家人一起开怀大笑。 
破两亿啦！我从转发中看看选哪五位朋友，送你们每人两张电影票。破三亿开始我要想想多送点啥	 小逃君报道：票房已突破2亿，快带上家人一起开怀大笑。 
首日破亿的幸运影票来啦！陪你笑！@Shirley---y@ @我是个范桶i@ @徐露LX@ @Chadce@ @love明love凤@ ，请留意微博私信，电影票正在飞向你哟！没有中奖的同学们别急，咱们机会还多多！@范冰冰@:一言不合就破亿！每破1亿，我就随机从转发中选五位朋友，送每人两张电影票	[江南style][江南style][江南style]任性！无需加任何特技！上映首日破亿！破亿！破亿啦！小逃君要绕操场奔跑10圈~~~ 
一言不合就破亿！ 今天开始每破1亿，我就随机从转发中选五位朋友，送每人两张电影票，带上你的TA去开怀大笑吧	[江南style][江南style][江南style]任性！无需加任何特技！上映首日破亿！破亿！破亿啦！小逃君要绕操场奔跑10圈~~~ 
何爷，想念你，玩起来吧！@何爷微博@:今天小刚导演发了关于你的微博，他很由衷。记得我为《麦田》找女主角时，你悄悄的来到我的办公室，你说：导演，剧本看过，我很想尝试。我说：100天不要离开我的视线。你说：我能做到。这就是为了电影这件事的一个承诺，你做到了！	夏日夜晚 
蓄势待发。@冯小刚@:箭在弦上。	一千个人眼中，有一千个《我不是潘金莲》。 
破六亿！抽奖继续！转发中我选五位朋友，送每人两张电影票。今天多选三位，送出我签名的羊驼公仔。	抱歉，此微博已被作者删除。查看帮助：http:t.cn/Rfd3rQV
冰冰	热 
笑看方圆，圆圆满满！9月30日电影院见！	范冰冰身穿Ralph &amp; Russo 2016秋冬高级定制礼服，出席电影《我不是潘金莲》发布会。范冰冰和李雪莲，融合在十二年的圆里，9月30日，笑看方圆。服装：@闵塔鲨@ 妆发：@胡議尹@ 摄影：@七明多@ 
@范小胖的暮榕冰嫣@ @夏凉cc@ @董振宇本人@ @檬味_i@ @潞潞潞Lucy@  电影票送你们，@九月的你16@ @胖冰0916生日快乐@ 羊驼公仔你俩一人一个哟 @范冰冰@:破五亿啦！转发中我选五位朋友，送每人两张电影票。再多选两位，送出我签名的羊驼公仔。	小逃君插播一则重磅消息：五五五五五五亿啦！ 可以，这hin动作喜剧～话说，wuli范爷 @范冰冰@ 这次又要放出什么福利大招！？ 
破五亿啦！转发中我选五位朋友，送每人两张电影票。再多选两位，送出我签名的羊驼公仔。你们都看了吗？喜欢吗	小逃君插播一则重磅消息：五五五五五五亿啦！ 可以，这hin动作喜剧～话说，wuli范爷 @范冰冰@ 这次又要放出什么福利大招！？ 
李雪莲这一路就是和他们斗智斗勇的！	【《我不是潘金莲》曝“演圆版”人物海报】由刘震云原著并改编、冯小刚执导的电影《我不是潘金莲》公布了一组“演圆版”人物海报，范冰冰、郭涛、大鹏、张嘉译、于和伟、张译、李宗翰、赵立新，范伟、刘桦等全明星阵容终于集体亮相。也预示了影片中小女子李雪莲一路与形形色色的大男人斗智斗勇、周旋不 ...
右手一筐小菜，左手一条腊肉。雪莲去赶大集了，有一起的吗？	李雪莲的问题是个圆。@范冰冰@ 
@豹豹不乖@ @一个喜欢范小胖的妞@ @星星star点灯在江湖@ @范EK@ @想一個名字HZ@ 电影票是你们的，@大爱大boss冰冰的Della@ 送你萌萌哒羊驼公仔，喜欢吗？@范冰冰@:首周末破四亿！说话算数，转发中我选五位朋友，送每人两张电影票。再多选一位，送出我签名的羊驼公仔。	 小逃君票房播报：首周末破4亿！4亿！4亿！ 成龙电影开画周末最高纪录！这个暑假，全家老小一起看成龙电影笑笑笑不完～ 
@替我幸福Karry@ @powqueener@  @饭小胖你给我站住@ 每人两张电影票，@She是我的初恋@ @懒惰鬼@@君君JunHe@ 每人一个手机壳， @朕朕S冰冰棒@ @A范小胖520@ 公仔是你俩的了@范冰冰@:票房破八亿！转发中选八位朋友，其中三位送每人两张电影票，再三位每人一个手机壳，另两位送出羊驼公仔。	 破8亿！！！ 七月暑期档票房冠军妥妥哒～！小逃君坐等 @范冰冰@ 范爷8亿福利！ 
票房破八亿！抽奖继续，转发中选八位朋友，其中三位送每人两张电影票，再三位每人一个签名手机壳，另两位送出羊驼公仔。	 破8亿！！！ 七月暑期档票房冠军妥妥哒～！小逃君坐等 @范冰冰@ 范爷8亿福利！ 
变换随心运动范	明明是运动范，却透着骨子里的性感，@范冰冰@ 驾轻就熟演绎。 
台上十分钟，台下十年功！	“六年的過程，只想分享給大家，希望能給點建議！謝謝”我的秒拍作品，一起来看~<（使用录制） 
衣架子，预测你还有更多可能！@小S@:天生的衣架子	百变女王@小S@ 甜美酷帅登场！女王的磁场真的不是盖的，甜美可人起来真要命，转眼酷帅风又袭来，迷弟迷妹们快来猜一猜，S姐这两套靓装是为哪两位“天菜”男神准备呢？每周四21:00爱奇艺，“妖”你见证哦！ 
开奖啦！@小青青耶耶耶@ @唯爱冰冰--伊冉@ @黎丹姓吴不姓黎@ @德津彤@  @yuki是个吃货@ 这五位朋友每人两张电影票，@纪金曼@ @因为你是范小胖@ 每人一个羊驼公仔。@范冰冰@:八月来啦！票房破七亿！抽奖继续	7亿啦！！场均人次第一，拳爆五湖四海，笑炸五脏六腑！ 小逃君也要响应@范冰冰@ 范爷福利号召，转发此条微博，并带话题 留言评论，即有机会获得电影票2张！躁起来～ 
八月来啦！票房破七亿！抽奖继续，转发中选七位朋友，其中五位送每人两张电影票。另两位送出我签名的羊驼公仔。	7亿啦！！场均人次第一，拳爆五湖四海，笑炸五脏六腑！ 小逃君也要响应@范冰冰@ 范爷福利号召，转发此条微博，并带话题 留言评论，即有机会获得电影票2张！躁起来～ 
吃货小分队集合！出发！	不站在“食物链的顶端”，怎么能组队访美食？@范冰冰@ 力组美食采访小分队，遍寻青岛家乡美食，左手一只蝎右手一只虾，还网到了一只美人鱼~冰冰队长在采访过程中又提出了什么让晨哥苦笑不得的要求呢？本周六20:30跟着挑战非主流美食！ 
@胡丽12149@ @吃货的小妖妖@ @南风_冰有冰邦@ @一生钟爱海贼王的钟诗慧@ @洁洁已过准备跟他幸福生活@ 电影票马上就到啦！@Ecoyukiii_你好范小胖@ @930我不是潘金莲@  @范家小胖0916生日哈皮@ 羊驼公仔也在路上啦@范冰冰@:破六亿！抽奖继续！	抱歉，此微博已被作者删除。查看帮助：http:t.cn/Rfd3rQV
老规矩！我的尺码一样来一件！姑娘们，这个秋冬花哨起来！	终于在立秋之时，把2016的秋冬系列带到了大家眼前，这一次除了平面的两次拍摄之外，还特别拍摄了视频短片。特别感谢@wintam0119@ @zengbohao@ 带来那么美好的影像，还要特别感谢@Nirokita@ 的文字。视频请戳链接<  <
为了亚斯蓝的荣耀并肩而立，带着信仰一起战斗。	【CP守护版海报】凌晨12点的钟声已经敲响，七夕到来之际，爵迹剧组给各位准备了一份成双成对的礼物，祝大家七夕节快乐。世间CP千万种，有兄妹，有基友，有情侣……你是哪一种？ 
欢迎收看第一届爵迹匹克运动会9月30，燃魂一战！@郭敬明@:哈哈哈哈哈！你们城里套路太深，我要回农村！笑pee了我	那边里约大冒险正在火热进行中，这边爵迹运动会也轰轰烈烈地展开了都憋说话，看完视频快点动起来！和奥汀大陆的王爵使徒们一为奥运健儿们加油！无场景、无服饰、无实物演绎，wuli王爵使徒的脑洞也是突破天际了< 
想看@陈砺志@:曹保平已经成为为数不多【品质保证】的电影导演，无论【李米的猜想】【烈日灼心】还是【追凶者也】，看完你都会由衷表达“好电影”……九月十五，一起去看	《烈日灼心》导演曹保平最新作品《追凶者也》曝光首款预告→< “摸凶团伙”@刘烨@ @张译@ @DuAn段博文@ @王子文Olivia@ @谭卓@ 奇现江湖。剧情时而幽默时而紧张，处处充满杀机，很有意思！影片将于9月15日中秋节上映~~约起！@电影追凶者也官微@ 
孙杨，你已经非常非常棒！我们的骄傲！	遗憾，感谢，我会继续努力！ 
这离分证四不假，但当时离分四假地！老干部王公道，你来给评评理！@大鹏董成鹏@:这个发型我给满分。	普法首选王公道@大鹏董成鹏@ ，结分离分没烦恼，亲朋邻里乐淘淘，狠好！< 
刚看到，迟钝，电影观念人人有！你懂的！  @李玉@:现场看着你，仿若玉环附体，冰姑娘，用绳命在演戏，恁做到了	最后一个镜头就要跟玉环姑娘说再见了，虽然累到吐血，但想想一个女演员的一生又有几次这样的的机会可以演两遍最钟爱的人物！十年间，再一次告別！想着，想着，不累了，想着，想着，平静了，心里满是感动，这是一个约定，只有两人知道，只此一生，只此一世！足矣！ 
不盯你们盯谁？看谁在办公窒里加班最后一个出来，怎么还不给我约会去！	夜幕降临，老板你怎么又在这儿看着我？@范冰冰@  
宝宝，今年你大丰收了！明年一起加油！ @王宝强@:恭喜贵妃杀青！祝早日上映	猫宁[打哈气]今天贵妃杀青，三郎却早已回到香港！好舍不得离玉环而去呀！，得起床干活去！愿你们今天都好！ 
卜胖胖，我喜欢这个红色耳机！	今日夜话：范小胖，周末的晚上你在听什么呢？@范冰冰@ @小茫@  
很好看的花色！估计又要人手一件啦！ @范冰冰工作室@:最新潮“范”，马上玩儿点不一样的，祝大家新年快乐呦！！！	新的灵感，新的潮流。跟着@范冰冰@ 以玫瑰Pattern将过去的街头风格，从新创！ 
太好了，终于看到你找到了美丽的媳妇儿，我终于放心了！好好爱！	一不小心，遇见了你；一不小心，爱上了你；一不小心，娶到了你；我会一辈子小心地小心待你！@谢楠@  
本质才是内心！ @任泉@:	分享图片 
没抽到台历的冰邦们，别哭！我做主再发一轮！	 [求红包]公布结果的时间到@岚晓妖@ @墨语默_@ @小椅子小Eva@ @歌滴歌不滴@ @明晗er@ @千零月@ @董董董董小傻@ @liang佳佳@ @央change@ @罪恶小鳯囡@ 恭喜以上十位中奖者，你们将获得范冰冰2014限量签名版台历，我们会通过私信与你们联系。 详情:< 
你的辛苦我看在眼里，也愿跟你同享收获的快乐！衣服很美，女明星很多，自己看着办吧！	Chris By Christopher Bu 2014 S/S RTW &lt; DOUBLE &gt; Lookbook. @ChristopherBu@ 2014春夏成衣系列 Photographer：@黄璨CAN@ Make up&amp;Hair:@李欣辕@ 
恭喜恭喜！狠狠爱～	 喜糖一到，就被工作室一水儿剩女们抢光啦！大家都想沾沾你们的喜气儿！哈哈~~~今日大婚 祝福祝福！ @杨幂@ @刘恺威@  
这种懒懒的感觉，真好！关于旅行你们还想说点什么？ @范冰冰工作室@:路易威登x范冰冰 ???? 幕后花絮 抢先看 ????@路易威登@:品牌缪斯@范冰冰@ 全球首次呈献，点击播放视频，即刻聆听她与NN14、路易威登以及旅行的不解之缘。	2014春夏@路易威登@ 广告特辑在风格极简的工作室中拍摄，以淡雅的背景色调让本来有着哥特式黑暗色彩的系列显得更轻松。@范冰冰@ 与NN14手袋Stephen Sprouse涂鸦款一同出镜，妩媚脱俗，“想带着所有路易威登的包去到世界的每一个角落”，她说。< 
哈，给你留着，好呗！ @杜海涛Hito@:我也想要台历！	转发并评论这条微博的，我会选出三人送他们范冰冰工作室2014年的台历，并且跟他们互粉。 
感恩！孩子们最不应该承受的便是痛楚，愿他们能解除束缚，展翅高飞！ @范冰冰工作室@:小朋友们很棒！也感谢为孩子们除祛病痛的白衣天使们～加油加油，早日康复	今年第一批阿里先心病患儿，在@上海远大心胸医院@ 手术很成功。 我在这里:< 
大鹏 过年好！老婆孩儿热炕头儿就最幸福了是不！ 新年加油 更上层楼 幸福满满！	老婆孩儿都睡了，和大伙儿聊聊的事儿吧。 
大年初二，刚起床看见这位仁兄，哈哈，你那么憨，春晚群马舞的编导知道吗？@李治廷@	Being forced to Horse on 年初一 lol #CNY  < 
哈，支持，主要是有家里人吧！ @谢娜@:哇！今天晚上八点，大家刚好和家人一起看我是歌手嗨起来哇	【初一开唱宣传片】新春亮嗓，马上就有天王天后，@张宇@：让我们欢迎迈克杰克逊、碧昂斯、邓丽君、张学友、赵传、周杰伦。天王天后大乱斗，欢聚一堂，静候经典齐聚，大年初一，晚上八点，新春开唱！ @韩磊-HL-@@張宇@@罗琦luoqi@@张杰@ @周笔畅@@GEM鄧紫棋@ @品冠victor@ <  <
谁还没有买到回家的票？快来找我，我用超能力瞬间把你们转移回家咯！	看看火车站机场拥挤的人群，刷火车票的疲惫，买飞机票的昂贵、短暂假期却在路上浪费。真希望拥有blink这样的朋友，她眼睛一闭一睁就到家了 
这个那••••••••其实，我这么二儿，我家里人一直都知道！  @范冰冰工作室@:武媚娘 来拜年	范冰冰微视拜年 [din推撞][din推撞]视频地址：< [花心]小胖，你那么二你家里人知道么 @范冰冰工作室@ @范冰冰@ 
武媚娘当然要送出5本啦大家猜猜武则天在剧中有多少套华服？（降低难度来点小提示哈:A80 B150 C260）大声告诉我你要把这份幸运带给谁，我帮你去实现！	  奉天承运，武皇诏曰：为感谢大家的支持与厚爱，特携众皇族爱卿，大开宫门，发放福利！即日起关注@电视剧武则天@ 及你喜欢的主创演员，转发并回答ta微博提出的问题，便有机会赢取太极宫头等赏赐：《武则天》特别版主创精美台历一本！（活动详情见图）@唐德影视@ 
一首真正能进入女汉子内心的歌！作为女汉子软妹子的代表，我服了，请问这么可爱的陶瓷公主哪里有卖？	情人节快乐！一份送给大家的小礼物。我的心意，你能感觉到吗？ 我分享了< 
武后时分，则你所爱，天加起来！	【来了！】全新升级的新浪娱乐iOS客户端今天正式报到啦！！有她在手，偶像新闻随心订，头条猛料早知道，热辣美图看不够。轻轻一点，走进指尖上的娱乐圈，更有多重礼品等你来拿哦！快戳大图了解她的完全档案吧下载地址：<  
娜娜，听着杰哥的歌，给家人拜年喽！马年更好，爱情更甜！ @谢娜@:冰冰棒，冰冰棒，新年快乐	两只小红拜年喽！ 
噢！脖子像這樣一直扭着可真夠我受的？ @小黄少@: 巴黎欧莱雅国际梦之队闪耀柏林 范小胖 你脖子还好吗	抱歉，此微博已被作者删除。查看帮助：http:t.cn/Rfd3rQV
小黑妞儿是不是也深有体会？演唱会要加油哟！ @吉克隽逸@:按完又是一条好汉！	拍摄间隙，有按摩师来帮忙，我的老腰就有救了！ 
你就好了，最累的终于熬过去了，迎接你的都是阳光海滩！努力后收获的幸福感总是很甜很心安理得！ @林心如@:加油啦????	累到不想活的节奏，有人跟一样感受吗？也许撒撒娇就缓解了，你们替我受着吧！[马到成功] 
因为我们从未离开过彼此！ @杨天真小姐@:很早和我的老板@范冰冰@ 说了要去创业的想法。她叫我不要有压力，不要内疚，担心我钱不够给我发满了全年的工资双薪和奖金。我一直知道我没有那么好，很多成绩来自于她，来自于整个团队，一起走过的最美好的青春不会忘记，我这个占了便宜的人，唯有带着感恩前行。	正式宣布，壹心娱乐今天开张啦。这是由陆垚，杨思维，陈洁三位合伙人创立的一家新型经纪公司，与导演编剧演员进行经纪全约合作。虽然没有土豪的支持，但我们有梦幻的团队；虽然没有盛大的仪式，但我们有满满的爱-全部的办公家具来自我们的明星朋友与业内同行。承载着梦想起步，坚信世界因我们而不同。 
痛并快乐着！	回家咯即将切回剧组模式 再回大唐@范冰冰@  我在这里:< 
哈哈，太可爱了！	抱歉，此微博已被作者删除。查看帮助：http:t.cn/Rfd3rQV
Angelica许久不见了，今儿匆匆，聊得不过瘾呐 @angelica张宇@: @范冰冰工作室@ 少见的低调风衣装扮非常顺眼优雅。	@angelica张宇@ 与@路易威登@ 代言人@范冰冰@ 在Nicolas Ghesquière呈现的Louis Vuitton秋冬大秀现场。 
终于要上映了！4月25日，想看吗 @范冰冰工作室@:@范冰冰@ @黄晓明@ 两位劳模，横扫五一劳动节！[真V5]	 博纳影业集团、幸福蓝海影视文化集团领衔出品，徐克任艺术顾问，@黄建新@ 监制，@张之亮@ 执导，@范冰冰@ @黄晓明@ @赵文卓@ @王学好@ 等明星出演的3D魔幻武侠巨制《白发魔女传之明月天国》公布档期并发布首款预告。该片将作为“五一最强片”于4月25日全国上映。<  <
以前是有图有真相，现在是连图都不顶用了，是不是得有了视频才能有真实世界？所以本姑娘工作室是否得考虑招一位24小时纪录片跟拍摄影师？有没有技术好、心灵手巧、战斗力满格的靠谱姑娘小伙儿来报名？以后我的新闻真实性就靠你们了，别再让那些无良的标题党博眼球赚点击率了～（Ps：看视频哟）	今天一条“范冰冰自嘲无中国味儿”新闻扩散于网络,引网友质疑.范冰冰原话“前几年外国人看到亚洲脸,常问是否日韩演员,我心里挺不乐意的.有一年我穿中国风裙子,没人再说这是来自日韩的演员,而说她来自中国.我就觉得我挺骄傲的!”有视频有真相,请媒体据理修正,否则将追究法律责任！<  <
快回来，没人陪我玩儿！一点意思也没有！	媚娘~我很快就回去找妳溫暖妳雙手了！嘻！@范冰冰@ @电视剧武则天@  
放松是另外一种滋味！ @范冰冰工作室@:《嘉人》4月刊最新出炉，@范冰冰@ 说，在向往自由自在这件事上，她也依然在路上，与你一起 摄影@冯海摄影@ 化妆@胡议尹@ 发型@陈锋1008@	3月14日 女神驾到！很多时候看见@范冰冰@ ，会感觉很励志。不管经历什么，不管评价怎样，她就是美，在银幕里，在硬照里，在惊鸿一瞥里。如今，说她是女神，没有人会不同意，美是一股心气儿，美是硬道理。 @范冰冰工作室@ < 
回复@嗣塰惟佳@:謝謝！@嗣塰惟佳@:发现你在演艺圈很有原则性 这是你与生俱来的本能 最后你还是得到了大家的认可 相信 你以后会更好	晨哥，终于合作啦！看，是不是还挺亲密无间的！@李晨@  
穿过我的白发的你的手！@黄晓明@ @王学好@ @赵文卓@ @电影白发魔女传之明月天国@	一夜愁白头，成魔也成疯 
逝者安息	为MH370逝者默哀，家人保重。 
回复@小彤_无敌醉意眼神@:哈，有你们最幸福！@小彤_无敌醉意眼神@:皇桑，这里都是咱们大唐朝有才的冰邦子们为您画的像啊。<	这谁画的？是我们家冰邦吗？哇！太油菜花的孩纸呀！ 
我好喜欢她！ @范冰冰工作室@:两只女王	范冰冰× Tilda Swinton | FilmAid Asia 2014“Power of Film&quot;慈善晚宴   
不记得青丝与白发，只记得你值得拥有	亦爱亦恨的刀光剑影，练霓裳一夜倾尽白头，你可曾记得她青丝时的模样？ @电影白发魔女传之明月天国@ @范冰冰@  
好像夏天来到！@阿迪达斯集团中国区@	 范冰冰 × adidas Originals 2014春夏Women系列 
专业打脸团队！啪啪！啪！听到声了吗？	今天一条“范冰冰自嘲无中国味儿”新闻扩散于网络,引网友质疑.范冰冰原话“前几年外国人看到亚洲脸,常问是否日韩演员,我心里挺不乐意的.有一年我穿中国风裙子,没人再说这是来自日韩的演员,而说她来自中国.我就觉得我挺骄傲的!”有视频有真相,请媒体据理修正,否则将追究法律责任！<  <
谁想试一下瞬移？告诉我，你想去哪儿？/@范冰冰工作室@: #X战警：逆转未来#团队越发壮大，必将是一场恶战！生死存亡关头，变种人集结成军，Blink怒开外挂，瞬移进入倒计时，你准备好了吗？[流星]	#X战警：逆转未来#发布最新角色海报：中国女星@范冰冰@ 饰演的Blink将是X战警系列电影中的新加入的角色之一，丹尼尔·库德摩尔则再次饰演的钢力士一角；另一版为肖恩·阿什莫饰演的冰人与艾伦·佩姬饰演的幻影猫。无水印海报@微盘@ 下载：< 
朕的秘密怎么全被你們發現了！[马到成功][马到成功] @范冰冰工作室@:朕的皇宫要高大上，精美新，朕的为人要柔霸乖萌，孝义两全	【《武则天》小宇宙解析：女汉子范冰冰是如何成为朕的】@范冰冰@ 版电视剧《》，投资三亿元、号称国产剧投资最高，它会打造一个如何富丽堂皇的大唐以及如何美艳无敌的武则天？武则天的服装间、发型间、化妆秘笈以及道具大工厂都将在此无死角地曝光！[推荐]~< 
这是愚人节的节奏吗？伦敦的同学看到了拍给我看看吧 @范冰冰工作室@:看到酷炫的Blink了吗？伦敦的盆油好福气，坐上火车，逆转未来#X战警：逆转未来#	x战警：逆转未来酷爆了！这种地铁宣传niubility！八位主演！ 
负我心者，万死不赦！	发布会现场，@黄晓明@ @范冰冰@ 一同为大家揭晓了 的“态度版”海报，其中黄晓明深情款款承诺了“许我情者，一生不悔”的誓言，而范冰冰则大胆喊出“负我心者，万死不赦”的宣言，两位主演更是在现场诠释了“爱就是要死去活来，恨就要恨得体无完肤”的爱情态度。 
这还是我的丁波吗	宅這麼一次就再也回不來了@电影追爱大布局@ 
朋友的衣服很好看！朋友的忙要一定帮！有梦想的孩子不容易！加油吧！	坚持一个梦想不容易，明天上午10点以我自己的名字命名的品牌ZHANGSHUAI在D2C平品开始预售了，我要特别感谢晓明哥，BABY，冰冰的鼎力帮助，帮我完美呈现，也要感谢陈曼，韦来，童梦，帮我拍摄。感谢我身边所有人的鼎力支持！我会努力，希望大家喜欢。预热抢先看< 
想黑我 没门儿！[lt切克闹][xkl转圈]	斑斑点点就像小情绪，，看似微不足道，却可以黑掉白皙，黑掉好心情。冰冰在@巴黎欧莱雅@ 中国研发中心，看到斑点生成的过程和机理，原来皮肤中的黑色素随时可能变成斑点现身，潜在的斑点更可怕，我们拒绝被黑，要在发生之前改变它！ 
這傢伙容易嗎？	第一口柠檬的滋味 。。。 
这世上，没有人可以不劳而获！ @范冰冰工作室@:今年的“饭”（范）都是硬货，营养高，吃到饱！	【范冰冰：冰封王座】：范冰冰以极高的商业价值和曝光度成为首位蝉联中国名人榜榜首的女星。2013年范爷拍摄了电影《X战警:逆转未来》、《画框女人》、《杨贵妃》，之后重回电视荧屏演绎女皇《武则天》，这些作品预计将于未来一年内与观众见面。@范冰冰@ @范冰冰工作室@ 详见< 
哈，听了这歌突然想起十几年前的北漂时光！虽然辛酸，但有梦想总还能坚持下去！我们都行，你也可以！北漂一族共勉！@苏醒AllenSu@:突然有种将要混不下去的感觉.....  这标题 乐库哥哥啊 给条生路吧...	【冰冰躺枪！苏醒新单《北京City》】“遇到过形形色色的投资人，名片太多太多分不清真愁死人；张口闭口就是女一号定了@范冰冰@ ，真的吓坏了没见过世面的小醒醒……”@苏醒AllenSu@ 首张纯说唱专辑主打《》强势发布！歌词真是字字见血！太犀利了！！< 
成都的孩纸都太热情了！每一次成都行都少不了一顿麻辣火锅！一年都可以不吃，只等去成都暴挫一顿！我不胖谁胖呢？哈哈哈！[愤怒]	谢谢各位粉丝们参加我们的开幕典礼。辛苦大家了， 希望你们在当晚尽兴而归及和有机会一睹范爷@范冰冰@ 的风采! 期待日后在连卡佛里再次见到你们哦! <  
我喜欢！ @范冰冰工作室@: 精！优！好！去！	 连卡佛又放送粉丝褔利罗！高贵美丽的@范冰冰@ 身穿Stella Jean的印花长裙，与连卡佛总裁Andrew Keith在连卡佛成都店开业庆典的红毯上合照,你喜欢她的裙子吗？喜爱就马上来选购哦！ 
予我一匹马????，我便与你仗剑走天涯！	彼此当年少，莫负好时光。予我一匹马，我便与你仗剑走天涯。 
我能说太喜欢这张吗？	#X战警：逆转未来# 听说Blink昨天穿越去了冰与火之歌…… 
没有什么不可能，快看！狼叔！ @范冰冰工作室@:昨天绝对是忙碌，愉快又圆满的一天，冰冰身穿优雅大气的礼服别有韵味，感谢@萧邦Chopard@ 价值千万的珠宝让现场更加闪耀。皮特、狼叔和冰冰一行三人昨日乘坐红眼航班，于今晨抵达新加坡，马上就要和新加坡漫迷见面了～期待他们更多精彩内容！	@范冰冰@ @范冰冰工作室@ @范冰冰粉丝团@ @卜柯文@ 昨晚拍的冰冰姐美美的套图来咯 还不快快收下珍藏[花心]????  ???? 
纽约午夜，工作还在进行，时差，时差，你在哪？我怎么找不到你呢！电影好????，有被震撼到！	纽约时间即将进入午夜，然而#X战警：逆转未来#首映礼的热浪还未褪去！“变种人大军”今日悉数到场集合，平日在各处“战斗”的大家好久不见，倍感亲切台下粉丝们的尖叫几乎如同超能力一半震破云霄啦！13号@范冰冰@ 与休·杰克曼、彼特·丁拉基将飞赴北京，热浪袭来，拭目以待咯！ 
到纽腰了！放心！	@范冰冰@ 抵达酒店，纽约的朋友们好热情，大家都冲着Blink来的！拿的都是她的海报！  
小四，加油！ @陈砺志@: 最好的时代，最好的小时代，青春不散场，盛年要重来。	【先导预告】“这是最好的时代，也是最坏的时代。你会忘记这个时代，但你，会永远记住我们。”又是一年盛夏了，期待与你们的 。——远处传来导演戴着氧气罩的呐喊：“……敬请期待，时代姐妹花环球作死大作战……”< 
辟谣，辟谣！谁骗了人找他们算仗去！	【】范小胖今日全天全职于大唐宫中饰演武则天，不会出现在其他地方，如有穿越乱入现象，纯属造谣。请大家不要轻信虚假传言，谨防上当受骗 
嗨！朋友，现在也不晚，我请你????电影怎么样？你的作品比我的海报还要美！谢谢！	#x战警：逆转未来#  前几天发图会不会可以获得首映的票[挖鼻屎] 
讨厌，又被抓住了！	昨晚，范冰冰携男友启程新加坡，在机场遭偷拍@adidasOriginals@  
苏红姐说，两位狠角色？我们到底是有多狠？@黄晓明@ @白发魔女@	@范冰冰@ &amp;@黄晓明@ ,这两个名字所具备的重量无可复制。他们够狠又敢拼, 战绩显赫,拥有摄人心魄的魅力和璀璨耀眼的光环,是毋庸置疑的明星典范。但他们却并未重复,反而一直在更新和超越,缔造新的角色高度。两位狠角色首次封面合作,绝色呈现@时装LOFFICIEL杂志@ 六月刊，没有惊讶，只有惊艳！@陈漫ChenMan@  
一个是情深不渝的太宗爱妃 ，一个是赤胆忠心的御前总管。一起期待@张彤@  @演员沈保平@  两位老师的精彩演绎，请大家支持他们！	抱歉，此微博已被作者删除。查看帮助：http:t.cn/Rfd3rQV
从今天开始就来给大家介绍中媚娘在宫里的小伙伴们，今天出场的是高阳公主和瑞安，希望大家多多关注～多多支持他们～@米露@ @演员高远@	 【武则天人物】你，窈窕神女颜。是大唐的公主，爱恨两茫，情谊何长，惨咽泣血堪别袂，不见世上有情天。 你，自始至终都选择竭智尽忠，竭诚尽节。予她，报以赤胆，予国，献以此生。@米露@ @演员高远@ @唐德影视@ 
小名blink太酷了！冰邦有愛，太疼你們了！小朋友一生平安！幸福！[花心] @小黄少@:哇！祝福！ @全球时尚红毯@:blink!冰邦为你骄傲!@小黄少@	网友“纳兰如歌”昨日即将临盆时专门跑到影院观看#x战警：逆转未来#，今日下午两点多顺利诞下小宝宝，小名取名“blink”…今日发帖向大家报平安，感动哭。希望冰冰祝福这个小生命。@范冰冰@ @范冰冰工作室@ @王亚楠1117@ @范冰冰粉丝团@ 
蓝胖胖终极进化Blink，新增手指头分岔能力 @哆啦z萌@:→_→ @曼芊@:→_→ @日式冷吐槽@:→_→@时尚界的潮人@: →_→ @分享最时尚@: →_→@鞭具蛋挞耀一@: →_→@英国时报@: →_→@一起神回复@: Blink有五个手指	别再说Blink打洞像哆啦A梦的任意门了，哆啦A梦有口袋，有竹蜻蜓，有时光机，Blink有么有么？ 
你不是說要牽着我去流浪嗎？怎麼這會兒又變成白☁️？	夏天来了呢，让我们牵着白云去流浪。@范冰冰@  
王皇后，深宫佳丽，斗智斗勇；物部天守，当局旗手，鼎力相抗。对手真是不少啊~看样子媚娘要在太极宫大战几回合了~	 【武则天人物】王皇后，深宫本如海，佳丽多花颜，一昭天下蒙宠争爱，凰亲国妻亦成烟云。物部天守，棋盘而开，战云密布。破竹气势败之当局棋手，回斗相抗得胜大好河山。@愤怒的S小姐@ @唐德影视@ 
咱俩要不要那么好？[花心]好哥们的意义就在于有事儿没事儿就互相吹捧！对不？[挖鼻屎]	我觉得一个系列电影能达到的最好的效果，就是看完之后会促使你去重看之前的几部力作…   恩，《逆转未来》做到了！ 片中有一段子弹时间的特技戏份，被秒到！范爷特殊技能好帅…如果你是个不折不扣的动漫迷，那我想，这部作品中的超时空穿越一定感动你。 
萧蔷，其形翩若惊鸿，一朝红颜堪悴损。李淳风，鞠躬尽瘁太史官，大唐传奇真豪杰。@演员孙佳奇@ @王泊文@ 演绎 一代美人、旷世奇才，精彩不容错过！	 【武则天人物】萧蔷，大唐国色天香，形影翩若惊鸿。一朝红颜堪悴损，此生玉殒而香消。李淳风，知天文地理，晓古今阴阳。 鞠躬尽瘁官太史，大唐传奇真豪杰。@演员孙佳奇@ @王泊文@ @唐德影视@ 
哇，才看到！惊着了！我的泉哥是真爱！[花心][花心]	@范冰冰@ ???? 
房遗爱，众谈盛唐悲歌，何及高阳遗爱。杨长史，唐宫美人天下，红颜女官笃行~如此猛将佳人，怎能不令人倾慕？！支持他们！@朱晓辉@ @陈思斯@	【武则天人物】房遗爱，清河房氏，名臣之子。众谈盛唐悲歌，何及高阳遗爱。杨长史，冰雪净聪明，唐宫美人天下，红颜女官笃行。@朱晓辉@ @陈思斯@ @唐德影视@ 
芭比美梦人人有，我也和你们一样	小胖家有很多娃娃的事情，冰邦们估计都知道了。今天给大家展示一下她的私人收藏！@Barbie芭比官方微博@ 
笑里藏刀的李义府， 葵藿倾阳的刘司药，会带来怎样的精彩呢@余皑磊@ @涂黎曼candy@	 【武则天人物】李义府，为虎傅翼，即又胡颜；面前与人言，面后笑中刀。刘司药，自荆钗布裙伴她至翠围珠裹，三年化碧，葵藿倾阳。@余皑磊@ @涂黎曼candy@ @唐德影视@ 
这游戏我喜欢，快来玩！谁能比我还像Blink我就跟她，或他一起去战斗！	这么多Blink,X战警们造吗？这是要一起上，累死哨兵，避免团灭的节奏吗！中间这位大哥，你KO了众美眉！就负责美人计吧！宇宙油菜花小盆友们，看别人玩不过瘾，来参与COS活动吧！Show Blink脸、PO Blink造型，原版Blink@范冰冰@ 会挑出最佳COS，通过时空门给你们送礼物哦！ 
谢晨哥，但发现晨哥送的都是姑娘们！	PM2.5、粉尘、花粉、甲醛、异味，危害着我们的健康，五大烦恼，一个对策，这次要把礼物送给几位好朋友，@范冰冰@ @马苏@ @霍思燕@ 希望这份礼物帮我、同时也守护着我们之间最洁净的友情。 
用心演戏的处女座好姑娘！加油！等着看你新戏！????说吻戏超多是吗？	昨日謝謝大家微訪談的熱烈參與，更開心大家對的支持迴響！端午節快樂！不管古人或現代人都要吃粽子，不管賢妃或曼曼也都要看星球喲！還沒趕上首播的快上搜狐！ 
像孩子一样开心的笑，快乐的跑，用心追逐梦想！媚娘和宫里的大头伙伴祝大家六一快乐，端午快乐！	 【六一&amp;端午主题趴】太极宫的各位皇族国卿组队前来向全城百姓发来贺电~！！ 恭祝大家节日快乐~[飞个吻] @唐德影视@ @范冰冰@  @李治廷@ @张钧甯@ @李李仁的微博@ @李_解@ @张庭@ @周海媚@ @张馨予@ @张定涵@ @李晨@ @任山@ @米露@ @陈思斯@ 
宝贝好帅！晴天幸福！ @晴天很生气@:@范冰冰粉丝团@ 十年快乐！六一快乐！冰冰快乐!	妈妈搬新家，把所有关于冰冰的珍藏品翻出来看了一遍，发现这个签名快要十年喽十年间，变化好多，我的宝宝都这么大了！但对你@范冰冰@ 依然未改变[爱心传递][爱心传递]@范冰冰工作室@  
十年了，看到视频让我这个再坚强不过的姑娘也哭的稀哩哗啦！听着十年的音乐，看着你们的一字一句，把我自己也瞬间转移到了十年前…庆幸这一生遇到你们，是你们的力量给了我，让我变成了有肩膀的姑娘，是你们不断的鼓励，让我进步的如此神速，有人问，这么拼命为什么？为我的理想和爱我的人！我爱冰邦！	视频看的小编哭成狗。亲爱的小范，十年的时间是长是短？当爱你成为一种习惯，就再也没有刻意地计算过时间。只是在不断地因你惊喜，为你骄傲的中，不知不觉已经过了3600天。感谢大雷精心制作的视频@绕着地球跑@ < 
辣么喜欢？送你一个做六一儿童节礼物吧！ @杜海涛Hito@:好美好美好可爱呀！	终于拥有自己的芭比了 开心！谢谢芭比娃娃珍藏版设计师Robert 现场为我画的画！小朋友们六一快乐！ 
这是规矩！	不杀女人，不碰小孩，这是规矩。———《这个杀手不太冷》 
哇！太子爷去的地方都好洋气呢！什么才人，公主，皇后都在组里等你回来玩！	武才人聲名遠播，太子爺在韓國工作，沒想到還巧遇武才人@电视剧武则天@ 
回复@亚如爱@:五，六岁？@亚如爱@:加油女神  好爱你  从五六岁开始到现在  我的女强人榜样	时间夺去了我们轻狂的眼神，却给了我们嘴角上扬的资本！ 
我們的心血，你們的肯定！最是值得！ @范冰冰工作室@:观大唐盛世，览沙场波澜，赏如玉美人，尽在《武则天》！	【双版海报曝光 】没错，就是现在！[花心]小宫女给你们的大惊喜~双版海报出炉喽！美到无法呼吸有木有！@范冰冰@  @李治廷@ @张钧甯@ @李_解@ @李李仁@ @李晨@ @张庭@ @周海媚@ @张馨予@ @张定涵@ @张彤@ @任山@ @唐德影视@ @恒大影视@ @中影电视@ 
刘贤妃，国色天香，君宠益娇态。辩机，少怀高蹈之节，却逃不过红尘之缘。期待这两位至真至情之人!	 【武则天人物】刘贤妃，千秋无绝色，君宠益娇态。深宫似海哀哉，薄命佳人惜矣。辩机，远承轻举之胤，少怀高蹈之节。大唐西域妙笔生花，红尘情恋奈何难逃，情若长久，岂在朝暮？@聂玫May@ @秦启东_瓜殿下@ @唐德影视@ 
我喜欢穿男装，丰毅哥和李晨也太帅了吧！ @电视剧武则天@: 金刚铠甲，金戈铁马，威武霸气！	@电视剧武则天@ 正在拍摄，片方曝光了一组@范冰冰@ 剧照，戎装加身的范冰冰大展“范爷”霸气，金刚铠甲英气十足。与张丰毅饰演的李世民在战场上共进退，上演了一出生死相依的戏码！< 
嘻嘻！ @小黄少@:???? @20世纪福斯电影@:主页君有点表述错误，更正：@范冰冰@ 是首位加入X战警阵营的中国面孔。（☆_☆）终于对了，工资不保	【另一种角度】作为X战警系列电影中首位亚洲女演员，@范冰冰@ 凭借着在《#X战警：逆转未来#》中惊艳的表演获得了国外众多影迷的喜爱，在IMDb最新的STARMETER(星热指数)Top100排行中，她排在了第19位。除表姐、法鲨、一美、狼叔及小恶魔这些常热明星外，快银伊万彼得斯新晋上榜排在第五（图3为排名） 
分享给你们！有才华！	冰家小编组阵百漫出行，绘图小能手们的&quot;Blink&quot;集合了！你被哪张萌到了？那就使劲夸夸作者童鞋呗，最最重要的是赞扬辛勤小编啦！哦吼吼！ 
你們辛苦了，路不好走，一定小心，好感謝我的品牌，給了那麼棒队服，你们是有爱❤️的好品牌！@adidasOriginaIs@	【爱里的心2014阿里儿童心脏病筛查】刚刚离开日喀则，继续向普兰县前进，大约还有1000km。感谢@adidasOriginals@ 为我们提供整齐的队服@陈砺志@ @上海远大心胸医院@ @麦特文化公益部@  
5年了，初次去阿里看到的那一双双清澈的眼睛，无法忘记。今年，@Mr_凡先生@ 加入了“爱里的心”捐赠队伍，我想我们能够做得更多，为了孩子们最真的笑脸！感恩！ @陈砺志@:吴亦凡成为项目在李嘉诚先生之后，第二位参与资助人士，我们一直谨慎前行，艰难而坚定地前行。	又见拉萨。一转眼，五岁了，过去四年我们在西藏阿里，完成了超过2万人次的先心病筛查，共有174个孩子在北京、上海成功完成心脏病手术。每一例手术，都使得一个家庭重获新生与希望。今年，我们项目组迎来一位新伙伴，感谢@Mr_凡先生@ 加入“爱里的心”捐赠队伍。<  <
如果你喜欢女孩，我想我会爱上你！	冰冰和@非常林奕华@ 的初次见面，谁都没有想到会那么愉快，导演鬼马的跳跃思维，也带给了冰冰轻松愉快的畅所欲言。冰冰对导演说：“ 如果你喜欢女孩，我会爱上你。”而这是@非常林奕华@ 笔下的范冰冰。@时尚芭莎@ 摄影@冯志凯@ 
第一次合作，不一样的感觉，很喜欢！你们呢？	发一张个人的网络版本 @范冰冰@ [呵呵] 
这部戏中的男人，各种威武雄壮！但每个人的內心都有一处最柔软的地方，等待你去打开！	 【《武则天》首曝海报之男神篇】 叱咤江山四方，唯我盛世大唐。[花心]   @李治廷@  @李_解@ @李李仁的微博@ @李晨@ @任山@ @唐德影视@ @恒大影视@ @中影电视@  
這部戏中每一个女人的美都各有不同！却都带着自己的小星球闪闪发光！	 【《武则天》首曝海报之女神篇】皇城佳丽，倾国倾城，如花美人空梦少，似海深宫波澜多。@范冰冰@ @张钧甯@ @张庭@ @周海媚@ @张馨予@ @张定涵@ @张彤@ @唐德影视@ @恒大影视@ @中影电视@ 
好呀，要是老年妆变这样！你们肯定觉得不过瘾吧！ @李治廷@:兄弟，你這也太有想像力了吧！ ????	故事是这样的：神龙元年武则天病逝，念念不忘了一辈子的爱恨情仇感动上天，则天穿越来到公元2014年，在养老院则天再次遇到了她终生的挚爱——做护工的李治！可惜命运弄人，李治是变成了年轻人，不知道这上一世的传奇爱情能否再次上演？@电视剧武则天@ @武则天电视剧百度贴吧@ @范冰冰@ @范冰冰粉丝团@ 
情是这世上最毒的药！@范冰冰工作室@:白发三千丈，感觉老板萌萌哒	#爱在七夕，为情入魔#很多网友问@范冰冰@ 白发魔女形象是怎样练成的？我们承包了全国27个省市大街小巷理发馆，才成就今天银幕上白发及腰的练霓裳（雾）魔范粉丝一起跟随金牌美术指导@TimYip-叶锦添@ 了解白发魔女创作历程吧< 白发三千丈，感觉自己萌萌哒 
#爱在七夕，为情入魔#你愁白头不太美，我愁今夜输几球！	【女神预告来了！】#爱在七夕，为情入魔#《白发魔女传之明月天国》心跳版情侣预告女神版来了！一起来感受@范冰冰@ 所饰演妩媚野性的练霓裳吧。谁曾说过“我不会让你后悔成为我的女人”，如今誓言随白发飘散在空中；谁曾赠我花前月下，如今却是空欢喜。是谁让她，为情入魔？< 
也要谢谢你和那么多帮助过我们的人！感恩！感动！ @陈砺志@:每次来阿里，做心脏病筛查时都不开心，因为平均发病率太高太高。但是每次也会有开心的时候，就是回访复查，见到手术后健康成长的174个孩子，那一刻觉得这五年来上高原吃的苦都值。当然，最应该感谢范冰冰同学，没有她就没有	米玛次仁 拉巴次仁 这是去年在上海救治的孩子，今天再次见到他们，两个帅哥都长高了近十公分，能跳能跑。高兴 < 
你是说我们合影背景台上的那几个？我看行！明哥霸气！既然明哥承诺了，各位就做个见证吧！	世界上最奢侈的爱情，是有个肯花时间陪你的人；人生最浪漫的时光，是有段奋不顾身的爱情；世上最动听的情话，是淡淡的一句“买了”。@范冰冰@ @电影白发魔女传之明月天国@  @路易威登@ 
白发魔女与她的卓一航还吃了成都????锅，爽歪歪！卓一航还对白发魔女说，这样可以打通任督二脉，白发转黑！永保不老容颜？反正魔女信了，你们信吗？	穿越啦！卓一航与他的白发魔女携手穿越到，已被成都粉丝的热情“辣”到，据说如果你们八月一日会到影院去看片，她俩以后会常来和你们一起玩耍。 
海报怒赞！	群雄犀利态度海报来了绵里藏针的客娉婷，终极大boss金独异，不迷大魔女只疼小萝莉的明朝第一捕快慕容冲，不让须眉的铁珊瑚，金国枭雄皇太极。@童谣@ @赵文卓@ @王学好@ @李欣汝@ @严屹宽@ 齐齐登场，你最喜欢哪一款？  
找的到彼此是多么幸福的感觉！ @李玉@:听见了，每个电影都是一个密电码，让我们找到彼此，以前是，将来更是！ @范冰冰@:李玉你听见了吗？南风丁波在呼叫你！@李玉@  @陳柏霖@:孤獨不是永遠的,在一起才是永遠的...	成都，每次来都会想起观音山，想起南风，想起丁波，想起种种种种⋯⋯ 
李玉你听见了吗？南风丁波在呼叫你！@李玉@  @陳柏霖@:孤獨不是永遠的,在一起才是永遠的...	成都，每次来都会想起观音山，想起南风，想起丁波，想起种种种种⋯⋯ 
都说要伤筋动骨一百天，钢钉侠怕耽误剧组只躺了一个月就又披挂上阵了。之前只觉得我的老乡是一个太漂亮的男演员但这件事情让我很感动！明哥骨子里是个太血性的汉子！ 手动点赞！@黄晓明@: 谢谢剧组大家庭对我那段生活不能自理时段的照顾，遇到了逢凶化吉，也收获了人间温暖	@黄晓明@ 小编现在正重温你去年39条，你只是漫不经心，提起4颗钢钉和35岁的自己。还自信满满调侃，学会了用上半身演戏。也偶尔翻到，钢钉侠和钢铁侠相遇。你总说这部电影是断脚力作，却忘了伤痛过去→<晓明你是坚强的演员，感谢为这部电影付出 
我曾经失落失望失掉所有方向，直到看见平凡才是唯一的答案。听得好想哭，有沧桑，力量，迷茫，躲藏，希望。不能错过，后会有期。	我曾经跨过山和大海，也穿过人山人海，我曾经拥有着的一切，转眼都飘散如烟，我曾经失落失望失掉所有方向，直到看见平凡才是唯一的答案。《平凡之路》，感谢朴树。7月24日，相聚有时。歌曲MV：< 歌曲试听：< 
如果你的红颜白了头发，你还会一如既往的爱她吗？ @范冰冰工作室@:红颜白发，爱恨成歌，在那熟悉的旋律中为爱成魔，泣恋七夕	 一首金曲带你回到记忆里，那些经典的场景幻化成如今的模样，忠贞不渝的爱情再度跃然于银幕之上。在哥哥张国荣《红颜白发》的歌声中再度感受@范冰冰@ 和@黄晓明@ 为大家带来的这段奇情绝恋吧。恨爱之间，分不散，红颜白发，更觉璀璨。<  <
霆锋小时候的梦想就是当一个大厨，他真的喜欢做菜，这次参与他的十二道锋味很好玩！大家都看了吗？听说萌萌哒 我哥做的菜好吃哟！@范冰冰工作室@: 今晚21:10，锁定浙江卫视十二道锋味，霆锋冰冰兄妹档，美味开餐！	众人眼中的范冰冰是“范爷”，但其实她也有着小女生的一面，在今晚开播的中，冰冰化身恋爱导师，和霆锋扮演情侣，撒娇卖萌一样不落。而结束和冰冰的巴黎之旅后，霆锋还将迎来特殊任务：还原十余年前张家辉吃过的一道美味，今晚21:10，为你呈现最独特锋味！< 
待我大功练成，賢妃嫁我可好????@張鈞甯@:「我就去演武則天！」陛下！這答案你可喜歡？！????????還是「我就去台灣找賢妃喝高梁！」????嘻！	魔女出题：，____________。（填得最精彩的，重重有赏） 
无论是你还是我，咱们自己单薄的力量远远不够。希望更多的人能贡献力量。爱心无大小，看行动！	抱歉，此微博已被作者删除。查看帮助：http:t.cn/Rfd3rQV
少年，别又吓坏了 @苏醒AllenSu@:找小醒醒写歌✌	魔女出题：，____________。（填得最精彩的，重重有赏） 
看你们俩打情骂俏这么亲热，不如待我大功练成，就来成全宝宝和一航！ @王宝强@:一航你别闹，人家这儿正表白呢 @黄晓明@:宝宝，不带你这样的，还能不能一起玩耍了！ @王宝强@:我就是你的男神	魔女出题：，____________。（填得最精彩的，重重有赏） 
萌哒哒的小练和小卓，一秒也等不了，快快玩耍起来 @范冰冰工作室@:好萌的小练练和小卓卓，赶快用起来	这个夏天伐开心？一起来领包包吧电影《白发魔女传》练霓裳&amp;卓一航表情包现已上架：①关注电影官方微信（添加微信号：dybfmn 或扫描下方二维码），回复”表情包”即可获得全部动态表情+微信聊天背景;②想要在QQ聊天中使用这套表情请戳< 下载。 
这个七夕和白发魔女一起去私奔吧！咱偷偷的，别告诉卓一航	来看看我拍的MV：“七夕和白发魔女截止到8月6日零点,关注“范冰冰工作室”美拍账号,并转发本条微博就有机会赢&lt;白发魔女之明月天国&gt;观影情侣套票(一共20套),...”，点此播放&gt;&gt;<（通过  录制） 
当然是练霓裳了，晨哥，小心卓一航削你！要不，你们月夜决斗吧！看白发魔女到底跟谁私奔过七夕呢？@李晨@:七夕我要请谁看电影呢？	白发魔女现在开始上映了！快来影院陪我过七夕！[花心] 
娜娜，白发魔女等着你！来嘛！来嘛！ @谢娜@:撒娇还行，女人都心软了好吗[花心]，看看看	七月三十一号白发魔女就上映了！魔女会在电影院里等着你们！不要让我等白了头发！ 
小红包是新宠！	范冰冰《白发魔女传之明月天国》首映造型，服装@ChristopherBu@，手袋@路易威登@，珠宝@萧邦Chopard@。感谢摄影师@搜狐马森@ 拍出如此美腻的范爷，快说你心动了没？！[花心][花心] 
告诉弟弟等他醒来，我给他来个真人现场表演怎么样？加油！不许不醒！	抱歉，此微博已被作者删除。查看帮助：http:t.cn/Rfd3rQV
黑白之间有灰，爱恨之间有泪，你我之间有谁？	爱，相思相知，两心相依，灵犀一点通；恨，多愁正苦，为情入魔，幽恨寄遥天 
通通給我退下，小卓你居然说我白毛浮绿水？无下限@黄晓明@  @范冰冰工作室@:荤荤素素好营养！我们跑堂的脑洞都被灌酒啦，练掌柜的你怎么看？	 《白发魔女传之明月天国》专场！拿到首映票啦，先来预热两个肉段版，断指大侠友情出演。 @范冰冰@ @黄晓明@ 
孩子坚持住！向前方奋战的救援官兵致敬！	#云南鲁甸县6.5级地震#【时间就是生命 小姑娘坚持住！】云南红石岩堰塞湖巧家县，一名4岁小女孩被埋，武警8750部队官兵正全力开展救援。由于房屋为夯土结构，目前救援难度较大。8月3日地震当天正好是小女孩4岁生日。小女孩加油，救援官兵加油！（央视记者田熙） 
看到了，好美！	为情入魔，银色曼舞…… 【从四月等到七月啊，31号就跑去看了《白发魔女传之明月天国》首映，终于抓住一个可以画女神的机会了！不知道能不能奇迹般的看到，每一次都好美~】@范冰冰@ @范冰冰工作室@ @电影白发魔女传之明月天国@ 
为生命让路，为同胞祈福???? @央视新闻@:【公安交管对通往灾区道路实施应急管理！】①渝昆高速昆明至昭通段、昭鲁快捷通道全线交通管制；②鲁甸通往龙头山镇的昭巧线、沙坝村至龙头山镇段只许抗震救灾车辆进入，其他车辆一律禁止通行！提示：救援紧要关头与救灾无关车辆请勿驶往鲁甸，为生命让道！	#云南鲁甸县6.5级地震#【遇难人数升至391人 呼吁让出生命通道！】①截至今天12时，已有391人遇难，1801人受伤；②牛栏江堵塞形成堰塞湖，塌方仍在继续，水位上升，武警正徒步挺进；③生命通道被堵！昆明通往昭通的昭待高速会泽收费站，抗震救灾专用通道被大量民用车辆占据。再次呼吁：为生命让出通道！ 
感谢大家！我更想看晓明和女票的结婚照！????你们说是吧[呵呵]@黄晓明@:感谢大家的支持，我知道你们想知道冰冰的男票是谁，继续加油吧	据第三方票房数据截至目前不完全统计，周六七夕大盘2.3亿，单日拿下9920万票房，（综合数据）单日过亿已成定局，成功打入华语片单日票房纪录前五名！为练霓裳、卓一航点赞！今年暑假，最具全民娱乐效果的华语爱情武侠巨制，错过了的话你跟朋友聊什么聊什么聊什么… 
那什么????对不住各位????我们家航航下次采访前我会记得给他吃药的！????????	她不叫妖女，她叫练霓裳，她现在是我的女人。 
天呐！同学们！你们太酷了！爱死你们了！七夕是你们的！	@黄晓明@ 为了支持晓明范爷新电影《白发魔女》，包场+造型，果然霸气。希望你们别走错停否则后果自负 
这真是从影以来拍的最长的一部戏，现场气温接近四十度，看来是要过一个湿漉漉的七夕啦！去年陪伴在你身边看一夜惊喜的人，今晚还在陪你看白发魔女吗？若还是，请珍惜！	  号外外号！武则天七夕送惊喜啦！电视剧开拍半年有余，媚娘@范冰冰@ 和李治@李治廷@ 都没有曝光过合影，小伙伴们有没有等的太辛苦？今天 ，小宫女我逮住他俩苦苦哀求拍到如此美图，祝小伙伴们七夕情人节快乐哈! 
终于！终于！可以喘口气啦！ @林心如@:恭喜恭喜，可以休息休息啦～????????	最后一个镜头，最后一声开机，最后一句媚娘。229个日夜奋战，终于杀青！没有欢喜，没有落寞，像告别一个知己，离别时像孩子一样玩耍！媚娘几个月后我们荧屏上再会！ 
是真❤️客串？还是要找个理由再来看看我们！这次不过隐，下次再来！ @李晨@:我杀青三个月后又一次去横店客串还看到你在服装间安排工作，229天！真心赞！期待这部史诗巨作，更期待下一次合作！	最后一个镜头，最后一声开机，最后一句媚娘。229个日夜奋战，终于杀青！没有欢喜，没有落寞，像告别一个知己，离别时像孩子一样玩耍！媚娘几个月后我们荧屏上再会！ 
不是恩爱，是心心相惜 ！小练和小卓的努力你们看到了吗？@黄晓明@（要是说恩爱，会有人来打我不）@范冰冰工作室@:票房已过3.5亿，直向4亿挺进奔袭！而对于练练和卓卓这样的秀“恩爱”，店小二表示么看够！你们敢再来点嘛！？	今天是上映第11天，截至周五，电影上映9天票房超过3亿元！夺目的票房数字，背后离不开主创人员不懈的努力，和广大影迷的支持。感谢各位，一起携手冲4亿[加油]小编在此奉上@黄晓明@ @范冰冰@ 独家幕后庆(en)功(ai)照！ 
快回北京，請我吃飯！	大家一起看《白发魔女》@范冰冰@  
素！死！啦！喜歡！@范冰冰工作室@:范冰冰“独战”群模，“金九”小胖，你值得拥有！@范冰冰粉丝团@: 此次是范冰冰第三次登上《VOUGE》中国版封面，更是该杂志创刊以来首位登上九月换季大刊封面的内地女演员。	9周年特辑重磅推出与@路易威登@ 设计师Nicolas Ghesquiere独家创意合作，重新定义时代新女性。中国女星@范冰冰@ 再登封面尽显当代酷女郎本色：“我予世界更多惊喜”。10位不同国家背景的杰出女性分享精彩人生历程，新一代Vogue女性独立自信、内外兼修，鼓励我们活得更精彩、更真实、更美丽。 
谁把我的妆容化的这么美？武则天就看你的了！	听说大家很喜欢《白发魔女》中练霓裳的妆容，好嗨森????还有大神写了精彩妆评在剧组的每天还历历在目，冰冰的辛苦付出剧组同仁的齐心协力，才能有这样美的练霓裳????小女子在此也谢谢大家对我的认可，小伙伴快去电影院看魔女吧 < 
好的品牌，美美发饰，暖心客户！谢谢你们对白发魔女的支持！ 一大早醒来都把我惊着了！爱你们！@范冰冰工作室@:感谢流行美一直以来对冰冰的支持！广州电影院，一群小魔女，快来快来数一数，2、4、6、7、8…… 1000！炎炎夏日还全副武装的小魔女（小魔男[挖鼻屎]）你们辛苦啦！	 20家影院！1000个白发魔女！流行美白发魔女团昨日攻陷广州！力挺代言人范冰冰新片上映！冰冰加油！@范冰冰@ @范冰冰工作室@ @黄燕lily@ 
衣服好美，但好緊哟！我連大氣也不敢出一口， 愛美的姑娘們！你們懂得！@范冰冰工作室@:One night in 上海	范冰冰身着Louis Vuitton 2015早春系列 出席SERIES ONE，THAT WAS THEN ,THIS IS NOW,全新系列灵感之约。 
一年一度Vogue FNO 摩登不夜城！ 艺术与设计的时髦派对！好玩！好逛！ @angelica张宇@ 期待再聚！	去年上海，今年北京，感谢敬业的@范冰冰@ 连续支持Vogue FNO! @Vogue服饰与美容@ @VOGUE时尚网@ @范冰冰工作室@  
杰哥新作！很浪漫！很动听！赶紧下载起来！	其实我没有离开，一点点的距离，让我们更珍惜彼此……很奇怪，我爱你，一直…… < 
怎么又把我们家的衣服全搬出来了！全给我拿回去！气死我啦！	Chris By Christopher Bu 2014 A/W RTW &lt; The Journey I: Jungle &gt;. Chris by@ChristopherBu@ 2014秋冬成衣系列. 官方网站: www .christopherbu.com Photographer:@黄璨CAN@ Make-up:@李欣辕@ Hair:@王耀葳@ 
我的那台正在去我家的路上，昨天在现场已经替大家先感受了一把，特别酷！ ????[花心][花心]有要和我一块看电视的吗	电视疯上瘦身了，配置更加高智商了作为1.28cm的超薄的称职代言人兼首席体验官，冰冰自然是要先来一台过把瘾滴。2014年9月16日冰冰生日当天，全国正式发售，大家准备好要抱回家了吗？酱紫我们还可以一起相约愉快的看呦  
我们的金九出刊啦！	我们阵容强大的九月刊：@范冰冰@ by Patrick Demarchelier, Saskia Debrauw by Solve Subdsbo, Magdalena by Nathaniel Goldberg, @孙菲菲LZ@ by Willy Vandeperre。 @Vogue服饰与美容@  
so cool! 这就是我！	原创的意义在于忠于最真实的自己。尽情展现自我，无畏周围质疑的目光与声音，我，以自己为荣！adidas Originals最新电视广告全国首播，看@陈奕迅所长@ @范冰冰@ 如何表达的态度！adidas Originals 最新广告“这就是我”（30&quot;完整版）    < 
期待！等看！ @陈砺志@:终极预告剧情大反转，原来《心花路放》喜剧下面隐藏了浓郁的文艺情结。人生的阴影，一走了之？撕逼了之？一夜情了之？还是，一笑了之？	#9.30心花路放#@宁浩和坏猴子电影生产队@ 执导的《心花路放》发布终极预告<，透出文艺气息：婚姻失意的@黄渤@ 与好友@徐峥@ 奔赴逃离阴影的旅程，两位好基友的友情也遭遇到最严重的考验&gt;&gt;&gt;<  你对这款预告怎么看？调查：< 
秋意浓	昨日，Valentino北京王府井新店开幕庆典盛大举行。范冰冰身着Valentino 2014秋冬流苏连衣裙亮相活动现场，与大家共同分享这一美妙的Fashion时刻。@Valentino官方微博@ 
做導演不易！美女導演更是辛苦！加油！大賣！ @范冰冰工作室@:恭喜梁大导演新作问世！	[ali哇]今天全国上映！八大看点诱惑惊悚全揭秘！烧脑剧情真凶难猜！的核心共鸣！悬疑推理惊悚片爱好者的你，约起你的小伙伴，9月12日，私家开放，在电影院等你揭开真相！@溫心Swan@ @成毅@ @赵多娜@ @尹正Andrew@ @CyberJelly赵美彤@ <  <
谢谢李老师的用心之作????谢谢老陈！珍藏????	有幸见证一份特殊的生日礼物：世界佛香作画第一人、韩国画家李吉雨先生，用30多天创作这幅画作——用点燃佛香在韩纸上作画，超过10万次香点，用不同香点孔径表现色差；这幅画中@范冰冰@ 图像，来源于国内最著名摄影@陈漫chenman@ 创作；李吉雨是因为先心病项目感动，而为小范创作了这幅作品。 
终于有一项国际顶级的大赛把第一届的第一站放在了中国，放在了北京！特别是这项大赛的赛车是电动的、零排放的，很环保！我们太需要新鲜的空气和晴朗的天空了！周末比赛时，没人请我，我自己买票也会去看！	9月11日，国际电动汽车方程式锦标赛（FE）发布会在京举办。咏而归影视总经理印小明，乐视网副董事长、CEO刘弘为范冰冰颁发了“国际FE清洁能源环保推广大使”荣誉证书。@范冰冰@ 是环保的身体力行者，她倡导清洁的世界离不开清洁的能源，而电动汽车正代表着清洁的未来。 
影像和装置艺术让路易威登的一个个故事在人们眼前生动上演！很棒的展览！	范冰冰身着@路易威登@ 2015早春系列亮相“‘系列一’全新系列灵感之约”LV上海设计展。“系列一” 对于一个设计师来说是一段全新的旅程，对于LV来说是一场充满惊喜的奇遇，而对于范冰冰来说，这一系列则让她和品牌彼此之间碰撞出更多的灵感火花。 
今天的北京晴空万里欢迎你们的到来！接下来的入院手术你们要勇敢！平安????快快康复吧孩子们！[呵呵]	已经接到孩子们，我们正在前往医院的路上。先心病抑制了他们的发育， 他们当中十几岁的孩子身高却如此娇小，一起祝福他们早日康复吧@范冰冰@ @陈砺志@ @清华大学第一附属医院@ 
业界最好造型师，我的好友！我们并肩走过那么多年，你一直在进步，从不停歇！好佩服！????这些照片都很美，小脸利器！姑娘们都会好爱吧！????????	我美丽的@范冰冰@ 妹妹戴上了我们家DONGTIAN&amp;MAGGIE的眼镜，更加霸气十足，女神范尽显。相识她十多载，眼见她的成长真心为她高兴如今取得的佳绩，@东田造型@ 的造型师一路伴随着冰冰，屡创美丽神话。继续努力！@东田智信雅@ @陈漫ChenMan@ @DARA蒋朋@ @何穗@ @苏芒@ < 
哇喔！妙不可言的魔镜就在我手上，我的想法它通通都能实现！10月14日，你也能拥有！	#点一点，千妆变#手机里发生了什么让范爷、春春、冰冰通通着魔？10月14日，等你来揭秘！< 
我的一次尝试，能够改变孩子的人生，就算承担风险也值！????	今天是，我们的5次进藏，万里行程，筛查孩子超两万；2014年，第5个年头，16批患儿，200名孩子。10月12日，拉萨—北京，15个孩子将来到@清华大学第一附属医院@ ，阿里红会同事们会全程护送孩子与家长们。“我的一次尝试，能够改变一个孩子的人生，承担风险也值。”——@范冰冰@ 
新血液！加油！杜华，好样的！???????? @乐华娱乐杜华@:1400天精心打磨，UNIQ不只是我一个人梦想，也不只是乐华娱乐的梦想，更是中国娱乐公司出击海外的首次尝试，《Falling in love》，豪赌明天，是因为始终相信有梦想就能创造奇迹！UNIQ，一起加油！	 中文版音源和MV正式发布！今天，你和 一起“Falling in love”了吗？ < 
我的心血！希望你们能喜欢！❤❤ @范冰冰工作室@:不见不散哟～ @电视剧武则天@: 媚娘和你相约明年开年档哟~@新浪娱乐@: 画面太美一定要抢先看~[花心]	电视剧《武则天》曝光了一组主演@范冰冰@ 与@李治廷@ 的绝美剧照，范冰冰饰演的武媚娘明目皓齿仪态华贵，李治廷饰演的唐高宗李治古装造型英气挺拔。剧照中范冰冰所饰是媚娘的武昭仪时期。该剧将作为2015年开年大戏登陆湖南卫视金鹰独播剧场。更多美图：< 
你要不要這么酷！也是蛮拼的！哈！????????	答案揭晓… 
也要谢谢你和我最棒的同事们！????还有那么多在帮助我们的白衣天使！大家的坚持都是值得的！因为我们最想看到孩子们清澈的眼睛和放肆笑容不是嗎？我們做到了！我們心很甜！感謝！感謝！❤❤	下午去医院看了今年最后一批手术的孩子，一个刚刚手术结束的孩子被送回病房，三位早些时间手术的孩子刚刚已经醒来。下周一还有两位大手术，需要院长主刀。今年是整个项目5周年，200个孩子得以在上海北京手术，都很成功很顺利，谢谢最美又善良的@范冰冰@ @范冰冰工作室@ 
200颗健康跳动的心脏，200个生动盎然的笑脸。团队5年来的点点滴滴都在心底，爱是最美好的礼物，我们一起再继续！	下午去医院看了今年最后一批手术的孩子，一个刚刚手术结束的孩子被送回病房，三位早些时间手术的孩子刚刚已经醒来。下周一还有两位大手术，需要院长主刀。今年是整个项目5周年，200个孩子得以在上海北京手术，都很成功很顺利，谢谢最美又善良的@范冰冰@ @范冰冰工作室@ 
如果这样，该有多好！???? @马特Matt@:执子之手，与子偕老，感动	【这才是秀恩爱的最高境界！】&quot;知道深爱是什么感觉吗？&quot; &quot;就像房间突然黑了，不是去找灯而是去找他。“知道婚姻是什么呢？” “婚姻就是吵架冲出门以后，回来顺便买了个菜'。 
生日快乐苏芒姐！永远阳光，执着，不停歇的你，别太累多休息！健康，平安，幸福！????@苏芒@:谢谢我亲爱的家人！！！你们的爱就是我的鸡血，永远在一起，永远前进。	她是我们所有人的姐姐，是永远的鸡血女王，她用自己的行动教会我们在追求梦想面前永远不要停下自己的脚步。她把青春和最好的岁月献给了时尚。她是不服输的人，一手创办了芭莎明星慈善夜，将慈善永远进行下去亲爱的苏芒，苏总裁，苏姐姐，我们祝你生日快乐，时尚人永远年轻！@苏芒@ 
一点一滴汇聚的爱是最美的@苏芒@:真好，有爱的人最美丽。 @范冰冰@:今天的北京晴空万里欢迎你们的到来！接下来的入院手术你们要勇敢！平安????快快康复吧孩子们！[呵呵]	已经接到孩子们，我们正在前往医院的路上。先心病抑制了他们的发育， 他们当中十几岁的孩子身高却如此娇小，一起祝福他们早日康复吧@范冰冰@ @陈砺志@ @清华大学第一附属医院@ 
哈！你說呢？???????? @张庭@:活酵母是不是很神奇？	敷個活酵母睡覺去！???? 
哈！我們就是神龜滅火隊！???? @范冰冰工作室@:朋友的事，就是自己的事????冰冰向来如此。就是太临时，急坏了同事们，下午茶喝到一半，抓衣服、抓化妆????也是一把救火集训！ 神龟神龟????伙伴们的共同回忆，期待你的大银幕表现！	【首映礼】梅根皮肤过敏缺席首映现场，难道是受雾霾影响？接到消息时，派拉蒙董事长 Rob Moore正在和@范冰冰@ 下午茶，范爷听说后特意赶来支援，Big Surprise！！！@范冰冰工作室@ @范冰冰粉丝团@ 
好美的妝容，我都❤️動了！????????	与各位朋友们分享我最新发表的作品（新古典主义）。11月号嘉人杂志。大家感觉如何？@尚雯婕@ @何穗@ @吕燕@ @DARA蒋朋@ @范冰冰@ @包一峰@ @白云峰@ @曹涤非@ @陈坤@ @东田时尚Leon@ @EG谢红宇@ @董荷斌HoPinTung@ @范庭略@ @韩笑雷@ @霍思燕@ < 
好吧，今晚看看節目也是醉了！ @李晨@:就在今晚，我们又来啦！	今晚21:10，@浙江卫视中国蓝@ Lamando凌渡将奔赴韩国开始奔跑之旅。人再囧途之“韩囧”即将开幕，敬请关注！@邓超@ @李晨@ @郑恺@ @陈赫@ @angelababy@ @王宝强@ @林更新@ @欧弟@ @王丽坤@ < 
秋水柳青情意长 @吴莫愁Momo-@:这顿螃蟹没吃上！ @赵一维@:2015这戏强@张璇的春天@:票房高过大楼房@沈婷婷baby@:万物生长很疯狂???? @杨迪@:夜夜笙歌像冯唐 @齐溪@:挖掘技术“靠”太阳 @李玉@:万物生长哪家强？	青春“靠”这四个字！ 
哈！我们都要美美的！???????? @佟丽娅@:怎么能这么美啊～ @范冰冰@:我的心血！希望你们能喜欢！❤❤ @范冰冰工作室@:不见不散哟～ @电视剧武则天@: 媚娘和你相约明年开年档哟~@新浪娱乐@: 画面太美一定要抢先看~[花心]	电视剧《武则天》曝光了一组主演@范冰冰@ 与@李治廷@ 的绝美剧照，范冰冰饰演的武媚娘明目皓齿仪态华贵，李治廷饰演的唐高宗李治古装造型英气挺拔。剧照中范冰冰所饰是媚娘的武昭仪时期。该剧将作为2015年开年大戏登陆湖南卫视金鹰独播剧场。更多美图：< 
的確沒有此事！請大家不要被騙！	【辟谣】今日，网络有消息称“范冰冰将做***手机，进军IT”，该消息属不实信息，请勿要传播，谨防受骗。 
有一天，我要演個女殺手！ @李玉@:@范冰冰@  @韩庚@	话说一直和太阳公公为敌的杀手范，路边抓到了一个…春心大发的秋水，杀手范，你要怎么处置他捏？ 
可弯可直！噢，别想太多，我说的是我的头发	香港《玛利嘉儿》（港版《嘉人》）11月刊双封出炉喽，高清图片捧上桌！冰冰身着美国经典品牌@RalphLauren@ ，幻想、浪漫、创新、古典、华丽的美式华美与她的媚帅激情碰撞 @陈漫ChenMan@ @胡議尹@ @化妆师高建@ 
感冒發燒真不好受，已被凍到透心凉！韓小庚，@韓庚為什么你的畫風跟我倆不同@？	赤峰，我们又来了 
“虎+狼”这个化学方程式老师没教过，你们可以去电影里找答案！	由@李玉@ 执导，@韩庚@ @范冰冰@ 主演的电影《万物生长》首曝“虎入狼群”海报！范冰冰“入侵”韩庚所在的男生宿舍，展现出别样青春的“虎狼大战”。而导演李玉和@制片人方励@ @路金波@ 以及原著作者@冯唐@ 的联合，更是“虎狼之师”&gt;&gt;&gt;< 2015年开春力作 
你敢向爱的深渊纵身一跃，你就会在坠落中长出翅膀！	 先导海报曝光啦~此次以“爱情深渊”为主题的海报以悬崖峭壁为主场景，暮色下一对飞向余晖的比翼鸟与整个画面构成了一副海誓山盟。悬崖边的脸庞仿佛在诉说：“你敢向爱的深渊纵身一跃，你就会在坠落中长出翅膀。”的爱情宣言。上映无期大有玄机，一同曝光的剧照也是那么的美哦[花心] 
色即是空！	“色”字当头 @范冰冰@ 
明哥，生日快乐！又大一岁了！长点❤️！照顾好自己！幸福！美好！	今天是我的生日，很开心也很欣慰，我们已陆续在十二个省市发放了黄手环，谢谢大家对&quot;让爱回家 防走失黄手环&quot;计划的关注与支持，现在还剩下200个黄手环赠送名额，有需要的朋友请关注@黄晓明明天爱心基金@ 公布的领取方式  关注易走失人群！[呵呵] < 
愿所有女孩都能找到属于自己想要的那份快乐！????	真正知道前者和做到后者，女孩就基本只剩快乐没有痛苦了。 
为了一个节目缝了二十二针也真是够了，还好你是男演员????，我能说等你好了，咱们打一架吧！我保证不戳你的眉骨！	节目的宗旨是传递快乐分享感动，所以有些事并不愿提及。那天，我尽力了没有录制后面环节我也很遗憾，不过还好，在机场补了一张合影算是留念。谢谢每一位关心支持还有质疑指责的朋友们，两个月了，早已恢复，勿念！我曾说过一句对白：“越被嘲笑的梦想越有实现的价值。”共勉！奔跑吧兄弟。 
一步之遥！这个必须看！随手转发拉低中奖率	年度贺岁巨制《一步之遥》姜文与葛优等集体诠释民国雅痞，周韵舒淇领衔魔都名媛北洋风情，乱世终极冒险震撼开启！低价影票22.22元一张，贺岁必看！11月11日购票并转发微博，将有机会获得iphone6，每小时抽取一台，还不赶紧来！< 
突然間看到了我的十八歲！我好想回去！???????????? @书生浪荡@:年轻的范冰冰真的美哭	@范冰冰@ 范冰冰早期拍完还珠格格拍的电视剧爱情宝典，从那时开始被她美哭…然后喜欢上，没错！我就是喜欢她的颜！ 
為你們驕傲！兄弟！???? @李玉@:俩福娃儿????????，这个夜晚属于你们！	恭喜《万物生长》的摄影指导曾剑@拍电影的曾曾@ 和 声音指导富康@富康的围脖@ 凭借《推拿》摘得第51届金马奖最佳摄影和最佳音效。两人都是马年本命年，获得金马实在是缘分中的缘分啊！@制片人方励@ @路金波@ 是不是该涨涨他们的片酬～ @李玉@ @范冰冰@ @韩庚@ 
哈，我已经滚远啦！！ @李玉@:谁快把这俩玩手机的熊孩子领走！	导演没手机，伐开心????@李玉@ @范冰冰@ 
热爱、执着能成就你所想！这期Cosmo很好读！我在看了，你们呢？@范冰冰工作室@:做自己喜欢的事情，怎么会累觉不爱呢？	@范冰冰@ 之所以越来越受欢迎，不是因为她十年如一日的美，而是在她这里，有太多可以折射自己梦想的切割面。钻石的璀璨离不开精细的切割，而人的光芒也得益于极度的磨砺。范冰冰有“累觉不爱”的时候吗？她说：做自己喜欢的事情，怎么会累觉不爱呢？！@范冰冰工作室@ @冯海摄影@ @卢昊大人@ 
晶姐发话了，大家一起来！用我们的力量，帮助孩子们实现梦想，让爱闪闪发光！@苏芒@ @谭晶官方微博@ @谢娜@	用我们阳光的笑容，温暖留守儿童孤独的心。请@苏芒@ @范冰冰@ @谢娜@ 和我用最阳光的笑脸传递温暖，用音乐陪伴孩子们快乐成长！发表晒出最阳光的笑容，@艾特三位好友@ 帮留守儿童实现音乐梦想。点击  < 
辛苦了戰友們！“她”是我们的心血！	武皇老矣，苍颜悲戚，迟暮含泪，江山还李。震撼的特效化妆背后却是“人皮面具”贴到起疹，隐形眼镜带到发炎。冰冰只有一句话爱“她”，付出再多都认了！这也是每个辛苦工作战友们的心声@陈敏正CMZ@ @梳妝造型安琦@ @侯云怡@ @摄影师隋晓龙@ @特效化妆师肖进@  特别感谢设计总监 @陈漫ChenMan@  
哈！我們的街頭暗號，別人都不知道喲！???? @何炅@:地球上，两个人，能相遇不容易…	收工后的大餐@張鈞甯@ @谢娜@ @何炅@ @吴昕@ @李维嘉@ @杜海涛Hito@ 
這么任性到底好嗎？???????? @范冰冰工作室@:老板，把范冰冰同款都给我包起来！就是这么任性！ @路易威登@	有一种款叫范冰冰同款。问过大陆和港澳地区好几个Louis Vuitton店的店长什么款最好卖，答案是惊人的相似---范冰冰同款，只要是她拎过穿过戴过的，第二天就有豪客来店里打包带走。最近这位称职的代言人又把几件2015早春套装穿上了杂志，不会念设计师Nicolas Ghesquière的名字没关系，请认准范爷这张脸。 
你自己的作品當然要說美嘍！????????	@范冰冰@ 做完造型我也是第一次看到，清爽的美丽。 
好電影，一定看！	支持推拿！ 
剛剛進宮，請多多關照！???? @电视剧武则天@:美得不像人类的武皇！小宫女要把你推向国际大舞台！~	日本网友请收图，你们美的不像人类的范冰冰又来了。。这次是范爷扮演14岁时候的武则天。。 
我殺青了，我心存感激！我盡力了！我愛你們！???????? @李玉@:最后一场戏是柳青最难受的一场戏，把大家演傻了，不是一个“棒”字能说得清的，戏里哭肿了眼睛，还要跟大家拍杀青照，也是醉了！	把你们都“杀”了，我们“青”春常在，心动常在，90个日夜，心情复杂，很不舍！万物生长，感谢大家！期待我们的未来！！ 
這真的是一場生命的聚會！???? @韩庚@:拥抱我们的制片人方励！电影杀青，但世间万物从未停止生长！	因为这部电影，我们拥抱在一起！这是@制片人方励@ 负责制作的第十部电影，其余九部小伙伴们知道是哪些吗~ @路金波@ @李玉@ @冯唐@ @范冰冰@ @韩庚@ @齐溪@ @沈婷婷baby@ @沙溢@ @杨迪@ @张博宇MoxiRescue@ @赵一维@ @吴莫愁Momo-@ @演员-雷恪生@ @李梦VIVIEN@ @吕行Jason@ 
莫问前路凶吉，但求落幕无悔！ @范冰冰工作室@:重重险关，句句箴言，盛世大唐，风云四起，千秋如梦，万古情衷。短短1分33秒，串起了武曌荡气回肠的一生。	《武则天》“权力版”预告片花 来袭！小宫女只想感叹一句：美！翻！天！从14岁的清纯少女到万人之上的至尊女皇，每一套造型都精美绝伦，“美到不像人类”的@范冰冰@ 再次给你最高级的视觉享受！< @范冰冰影迷会@ @范冰冰工作室@ 
真的是這樣！????那我們是不是要改變呢？還是要改變呢？還是要改變呢？	原来以为，只要拼命工作，就能过上好生活……十几年过去了，我发现，拼命工作的人都过上了拼命工作的生活…… 
我家兒子好帥呢！????????	大头儿子和小头妈妈。看，大头拍起照来，是不是还挺有妈妈的范儿呢[花心][花心]@范冰冰@ @闻闻窝宠物社区@ @诺宝派宠物@ 
日月当空曌，则天长安笑。这次和漫漫@陈漫ChenMan@ 玩得特嗨！ 还有我的化妆师@胡議尹@ 表妹、发型师@化妆师高建@ 喜欢！	侍臣鹄立通明殿，一朵紅雲捧玉皇 
大家好，我是邓超。刚才冰冰给我送药，可是我把水给她了，怎么吃呢？愁啊！娘娘是不是在赶来的路上？我好怕！啊！！！等等救我！	大家好，我是范冰冰。唯一的男神超nice，居然和我合影，还给了我一瓶水，叮嘱我早点回家，让我哭会儿。 
快戳我們的花絮視頻！在剧组的每一天都是這麽鬧！一起疯一起笑一起流泪！一起静候万物生长时！明年五一！	由李玉执导，范冰冰、韩庚主演，改编自冯唐同名青春小说的电影《》在经历了3个月的拍摄后，于12月4日下午在京宣布进入关机阶段，并率先定档明年五一，主创更放话：“吃定五一档”。更多采访< 拍摄花絮< 
治廷作曲，文山大哥填词，靓颖演唱，我们的主题曲《无字碑》，今晚00:00大家就可以听到咯！！@范冰冰工作室@:从初冬到盛夏，这是所有人的心血，所有人的努力~~~敬请期待开播~~~~	【今日奏折】《》首部花絮纪录片曝光啦！重现历史上的盛世大唐，为观众揭秘绝美武则天更多造型，更有武皇@范冰冰@ 为该剧沥尽心血的“证据”哦~~此外小宫女将最新剧照福利送上！12月19日，帝后争锋，大唐风云，敬请期待震撼开播！< 
18号我在现场听你的现场！ @张靓颖@:昨天不是真正的挑战，真正的挑战是明天你们将听到的《无字碑》我要在18号第一次唱现场[hold住][hold住][hold住]	两年前的liber tango < 和今晚的liber tango 你们感受一下。 < @张靓颖@ @王铮亮@ @文薇小提琴@  
@陈砺志@:第一次电视访问献给可凡倾听，是因为，五年来冰冰筹款千万完成200例心脏手术，功德无量。我作为项目执行者，见证不同寻常的冰冰。感谢阿里红会、清华大学第一附院、上海远大心胸医院，还有李嘉诚先生、吴亦凡小朋友。我们会联合佳平医疗，在阿里开展全民体检项目。路还长，一起走！	在上海见到许久没见的可凡大哥，还是那么亲切，大家看出来他瘦了30斤吗？好厉害！今天和老陈我们一块儿在@可凡倾听@ 聊聊“爱里的心”的五年，路还远，我们一起走。可凡大哥的新书四时花开，晚上回去读咯！@陈砺志@ 
這部戲合作的人都是在一起几十年的朋友，朋友在一起才是最快樂的事！???? @梳妝造型安琦@:青梅竹馬的戀人 千呼萬喚的期待 敬請關注喔 @范冰冰工作室@:很期待冰冰和晨哥的首次合作相识十几年，终于等到你……们的对手戏啦！	 【@范冰冰@ @李晨@ 青梅竹马心系魂牵 女皇初恋曝光】将军李牧是武如意蜕变为武则天道路上十为关键的人物，而在现实中，@李晨@ 也是@范冰冰@ 十多年的好友，此次二人的首度合作，“范爷”配“running man”的新鲜组合和小宫女一起期待吧！《武则天传奇》李牧之死：< 
你唱的真好！聽完耳朵會懷孕喲！???? @张靓颖@:谢皇上的邀请～这是我唱过所有歌曲里最温婉也是最霸气的一首作品！从涉世未深的少女到气宇轩昂的帝王，只能说：文山老师，治廷，所有感谢和对这首歌的喜爱，都在演唱里！	 小宫女一早就为大家送上 好消息！《武则天传奇》主题曲《》将由华语天后@张靓颖@ 倾情献唱，@方文山@ 作词，@李治廷@ 作曲，歌词娓娓道出了武则天这一生经历辛酸荣辱却无悔无愧的心声，还原了一个有血有肉，有情有义的武则天。@张靓颖歌迷地带@ @李治廷粉丝团@ 
靚穎，治廷，方文山大哥你們太棒了！ @电视剧武则天@: 期待李治和李治廷的的心血之作 @李治廷@: 這首歌是李治和李治廷的心血。希望你們喜歡 :) 好感激@张靓颖@ 為這首歌的付出！你的演繹讓我非常非常感動！這一次能夠與大師@方文山@ 合作也真的太榮幸了。謝謝你們！Thank you !!	 小宫女一早就为大家送上 好消息！《武则天传奇》主题曲《》将由华语天后@张靓颖@ 倾情献唱，@方文山@ 作词，@李治廷@ 作曲，歌词娓娓道出了武则天这一生经历辛酸荣辱却无悔无愧的心声，还原了一个有血有肉，有情有义的武则天。@张靓颖歌迷地带@ @李治廷粉丝团@ 
北京大妞大漫漫在美国的个展开幕了！想看！@陈漫ChenMan@:	 开幕倒计时 经过了几天高密度的、紧张的、专业的筹备，漫姐在洛杉矶@lalouver@ 画廊的“东.西”个展 当地时间12月10日晚7点即将开幕 @陈漫ChenMan@ < 
媚娘，权还是情，爱还是恨，荣还是辱，善还是恶？但我知道你确实没负此生@范冰冰工作室@: 沙场上的血雨磨砺，后宫中的杀伐决断，权力欲望，爱恨交织，辉映天下，不负此生！	【武则天首款“权力版”预告曝光】乐视年终大戏@电视剧武则天@ 即将在12月底开播。今日，该剧首款“权力版”预告片曝光。片中，深宫险恶，风云四起，将武则天与唐太宗李世民、唐高宗李治，三代帝王之间的命运交缠描绘得动人心魄！@范冰冰粉丝团@ @范冰冰影迷会@< 
海涛，看大本营喽！????????	冰冰姐永远是我的女神！冰冰姐最瘦！！！最美！！！！！@范冰冰@ 
她和他们的故事，将从这里开始！	 四季版片花——春之孺慕•武媚娘李世民相爱相杀|< 夏之灵犀•媚娘李治赤诚热恋|< 秋之无猜•媚娘李牧甜过初恋| < 冬之相知•媚娘李恪爱无结局| < @范冰冰@ @李治廷@ @李晨@ @李解@ @唐德影视@  <
娜么地不容易，我们都还是挺过来了，在找寻梦想和幸福的这条道路上，娜娜和我都不曾放弃过！ @谢娜@:好久没有扮上啦，为了冰冰的武则天，话说百变大咖重现江湖 想说以为武则天这服装看着好看，穿了好久，而且衣服，头饰，真的……真的……好重………，冰冰不容易，必须赞一个 @范冰冰@	@谢娜@ 居然缺席本周六《快乐大本营》开场？！——原来她当武则天去啦这套龙袍是@范冰冰@ 自己珍藏的戏服！为了节目特意空运过来！给大气的范爷点个赞造价50万！重25公斤！纯手工定制！26位工人连续赶制3个月才完工啧啧啧~总算见识了神马叫做华服！娜娜，请问穿龙袍的感受如何呀 
看，有何老师罩着我？我怕谁？[挖鼻屎][挖鼻屎]明天，请快乐起来吧！@何炅@:哪儿有特别艰难？请不要随便揣摩一颗快乐的心，我冰一点儿也不重！好！嘛！明晚见	你没看错！女神@范冰冰@ 手机屏保曝光，称自己“死胖子”！本周六张丰毅惊爆范冰冰真实体重：60公斤！OMG！女神你肿么啦为了抱得美人归，@何炅@ @杜海涛Hito@ 也是蛮拼的！貌似特，别，艰，难范小胖，你该减肥啦快来参与 话题！帮帮她@范冰冰工作室@ 
有安琦的梳妆和候姐的衣服才有这么妙的画面！这是你们的功劳！ @梳妝造型安琦@:太好聽了我們的帥皇桑真棒 喜歡這個紅白配的造型 @侯云怡@ 咱們合作無間啊 是不是啊@范冰冰@  @范冰冰@:终于等到你！	 【主题曲MV】【《武则天传奇》MV曝光 李治廷张靓颖携手创百万点击】今天小宫女给大家送上终极大礼！由皇桑@李治廷@ 作曲，@方文山@ 作词，华语天后@张靓颖@ 倾情演绎的主题曲MV《无字碑》！~[江南style]小伙伴们快听起来哦~@范冰冰@@唐德影视@@范冰冰工作室@ 猛戳：< 
好好听的歌，好感动呀！所有的女孩听了都会掉眼泪吧！我能说我是全球第一个听这首歌的人吗？@谢娜@	< 
终于等到你！	 【主题曲MV】【《武则天传奇》MV曝光 李治廷张靓颖携手创百万点击】今天小宫女给大家送上终极大礼！由皇桑@李治廷@ 作曲，@方文山@ 作词，华语天后@张靓颖@ 倾情演绎的主题曲MV《无字碑》！~[江南style]小伙伴们快听起来哦~@范冰冰@@唐德影视@@范冰冰工作室@ 猛戳：< 
有才华，我爱才呀！	  海棠开后春谁主，日日催花雨。谁能料到昔日这无忧无虑的少女将会是这大好河山的主人？所以只能用画面去定格你此刻的纯真！看到网上剧照开了这样的脑洞~期待上映！祝收视长虹！@范冰冰@ @电视剧武则天@ （期待更多美照，我打算画一整个系列） 
太！好！听！今夜就此循环了！	[推荐]《无字碑》[甩甩手] 可以演唱到好作品总是让我感觉很幸福< @李治廷@ @范冰冰@ @方文山@ 
他们说风雨中这点痛算什么，擦干泪不要怕，至少我们还有梦！	@武媚娘传奇@ 幕后起底！@范冰冰@ 遭木棍爆眉骨&gt;< 古装大剧《》已于昨晚24:00震撼登陆爱奇艺！@范冰冰@ @李治廷@ 联合主演，汇聚@張鈞甯@@李晨@@周海媚@@张庭@@李李仁的微博@ 等两岸三地实力派演员家加盟！高清正片首集欣赏&gt;< @范冰冰粉丝团@ 
只能说，逆天了！	湖南卫视宫廷童话瑰梦人生巅峰巨献《》12月21日首播CSM30城市网收视率2.46、市场份额6.15，排名第一！CSM50城市网收视率2.28、市场份额6.05%！全国网收视率2.14、市场份额6.13，首播直接破2！电视剧史上开播最高收视纪录诞生！简直逆天！@范冰冰@ @唐德影视@ @高翊浚@ 
冬至咯！吃饺子！看武媚娘！刷檀木！ @范冰冰工作室@:没看上电视的小伙伴，24点看腾讯视频三集联播噢～明天中午檀木一起刷起来哟喂！	看完《》首播，大家被范爷美到了吗？错过的小伙伴等小企鹅24点更新呀当当当，明天（周一）中午12点@范冰冰@ 驾到！在腾讯视频和大家一起玩弹幕！求同框的把握机会哦！截到范爷弹幕并@腾讯视频@ ，即有机会获得范爷签名照< @范冰冰工作室@ 
有！刚刚看完！你们觉得好????吗？	有人在看吗… 
锁定芒果啦！晚上7:30见！	美，就是这样子啦，今晚芒果台，武媚娘来啦 
就听何老师的，约！	这画面……感觉电视屏幕会不够用的。今晚，武媚娘空降芒果台，约吧！@范冰冰@ 
乐坛武则天唱我们的《无字碑》可好? @张靓颖@:2005，我是选手。2015，我是歌手。你们想听我唱哪首？	 I am a Singer，我是歌手第三季欢迎你们！@西藏昌都人韩红@ @孙楠@ @古巨基Leoku@ @张靓颖@ @胡彦斌@  @天生歌姬A-lin@ 
约呀，你们都准备好！ @任泉@:到底约不约@angelababy@:太美了吧[花心][花心][花心][花心] @范冰冰@:今天晚上19:30湖南卫视，我们约吧！	【《》今晚开播 范冰冰演绎宫廷励志童话】宫廷童话瑰梦人生巅峰巨献《武媚娘传奇》今晚19:30湖南卫视震撼开播！由@陈漫ChenMan@ 设计的三帝终极海报新鲜出炉，更为大家送上搞笑特辑，为你揭开拍摄背后的故事。@高翊浚@ @范冰冰@@李治廷@ @唐德影视@ < 
今天晚上19:30湖南卫视，我们约吧！	【《》今晚开播 范冰冰演绎宫廷励志童话】宫廷童话瑰梦人生巅峰巨献《武媚娘传奇》今晚19:30湖南卫视震撼开播！由@陈漫ChenMan@ 设计的三帝终极海报新鲜出炉，更为大家送上搞笑特辑，为你揭开拍摄背后的故事。@高翊浚@ @范冰冰@@李治廷@ @唐德影视@ < 
媚娘的少女时代！等七集快开始了！电视机前座好了沒有？	武媚娘传奇收视率第一，祝贺冰冰头上被30斤的假发拉的大血包没白疼，昨晚去冰冰家玩，范妈妈拿出冰冰13岁的影楼婚纱照，和15岁的沙龙照，呵呵，美人依旧，没有任何改变，就是美！@范冰冰@ 
收视破了3，大黑????和小肥????再撕次名牌此试比试？晨儿哥？敢不？[懒得理你] @李晨@:坐等收视破3 @范冰冰@:小胖就是出手了！怎样？不服来辩？ @卜柯文@:小胖妹你是以体重取胜的吗[挖鼻屎][挖鼻屎][挖鼻屎]@范冰冰@	 小胖一出手，就知有没有！武皇首日播放量破亿，更破纪录（纪录保持者：古剑奇谭：6828万次）！艺人指数破9，达到9.27，排名NO.1！卫视收视率持续走高，50城收视率2.369%，34城2.458%！@范冰冰@ @范冰冰粉丝团@ @范冰冰工作室@ 
小胖就是出手了！怎样？不服来辩？ @卜柯文@:小胖妹你是以体重取胜的吗[挖鼻屎][挖鼻屎][挖鼻屎]@范冰冰@	 小胖一出手，就知有没有！武皇首日播放量破亿，更破纪录（纪录保持者：古剑奇谭：6828万次）！艺人指数破9，达到9.27，排名NO.1！卫视收视率持续走高，50城收视率2.369%，34城2.458%！@范冰冰@ @范冰冰粉丝团@ @范冰冰工作室@ 
台前幕后有谁可以置身事外？剧组的兄弟姐妹们辛苦了！好成绩是大家的！我为你们骄傲！@武媚娘传奇@	【@范冰冰@ 女王蜕变 戏如人生】敢于放言自己就是豪门，敢于承包国内外红毯，“范爷”的名号一直在贵圈都很响亮。在暌违六年后，她携《 》一记回马枪杀回，霸气丝毫未减，“武则天”的成长史倒是与范爷的经历相映成趣。娱乐底片为你揭晓这背后的辛苦和努力，详情点击：< 
韦妃娘娘，今晚上求轻虐！????????????	有你们想象的坏吗？ 
谢谢爸比垂爱！小新，等你下了威虎山，来我朝做大将军可好？！	我爸说他就爱看范冰冰，就要看武媚娘，眼里也没谁了。 
看朱成碧思纷纷，憔悴支离为忆君，不信比来常下泪，开箱验取石榴裙。/如意娘	“看朱成碧思纷纷，憔悴支离为忆君.”希望有朝一日，媚娘可以真正的与君相知，为君分忧！   @武媚娘传奇@ @范冰冰@ 系列图之二！更多精彩！敬请期待 
看朱成碧思纷纷，憔悴支离为忆君，不信比来常下泪，开箱验取石榴裙。/如意娘	“看朱成碧思纷纷，憔悴支离为忆君.”希望有朝一日，媚娘可以真正的与君相知，为君分忧！   @武媚娘传奇@ @范冰冰@ 系列图之二！更多精彩！敬请期待 
新款！金色！新年！[花心]	冰冰和三叶草的首个合作系列发布，强烈的金色和黑色的碰撞，绝对有范儿。直接去三叶草店，别再问我要“范冰冰同款”啦。和 @adidasoriginals@ 合作愉快，明年也要一起幸福哟。 
是有种很被宠爱的感觉！粉色，紫色都是我最爱的颜色！以前对花花䓍草不是很敏感的我，现在也有了不一样的感受，到底是心变的柔软了？还是长大了呢？	MENGFLORA品牌给范小姐家里送来鲜花，据说每个星期都会有，是不是很幸福呢@MENGFLORA@ 
媚娘觉的这事儿可以有！ @韩庚@:媚娘，娶秋水可好？???? @范冰冰@:好吧！让我考虑考虑！ @筱筱努那_Hyowoon@:右边请矜持→_→@贤之冰小鱼@: #此生愿为单身狗，要嫁只嫁范冰冰# @筱筱努那_Hyowoon@ 爷，请收下我的膝盖	昨晚的《》中，范爷一身男装风流倜傥气质不凡。填词游戏走起来：______________，要嫁只嫁@范冰冰@ 。小企鹅先来：#此生愿为单身狗，要嫁只嫁范冰冰#！【咦好像有什么奇怪的东西混进去了】 视频地址：< 
好吧！让我考虑考虑！ @筱筱努那_Hyowoon@:右边请矜持→_→@贤之冰小鱼@: #此生愿为单身狗，要嫁只嫁范冰冰# @筱筱努那_Hyowoon@ 爷，请收下我的膝盖	昨晚的《》中，范爷一身男装风流倜傥气质不凡。填词游戏走起来：______________，要嫁只嫁@范冰冰@ 。小企鹅先来：#此生愿为单身狗，要嫁只嫁范冰冰#！【咦好像有什么奇怪的东西混进去了】 视频地址：< 
画风好可爱！好喜欢！看起来真乖呀 ！还有囧眉！哈哈！@武媚娘传奇@:【小宫女直播】不同风格不同个性一样可爱～【直播随手拍：<】	北方有佳人，绝世而独立，一顾倾人城，再顾倾人国 @武媚娘传奇@ @范冰冰@ 
哎！我说！(请用北京话念）都快来都陪我看吧！这几集正好到裉节上！	今天休息  媚娘终于有时间可以安心看戏了 准时准点 
你都长大了，媚娘还没変！	李治mini and 李治Plus。他们都和范冰冰在一起. 
今晚大荔枝终于来了！ @范冰冰工作室@:终于等到你…….................长大！	 看了看今天的朋友圈，更期待今晚大荔枝@李治廷@ 现身~李治mini更新为李治plus咯！[江南style][江南style] @李治廷百度贴吧@ @唐德影视@ 
生命中最重要的事！ps：老陈快练好普通话！ @范冰冰工作室@:五年艰难险阻，五年风雨同行，怕的不是困难风险，怕的是失去那些纯真笑容，感谢@可凡倾听@ 让我们能再好好回首这五年！（PS：陈总你好帅你造吗）	昨晚的《可凡倾听》，第一次完整讲述五年艰难历程，这个公益项目的缘起，五年经历，手术风险，路途危险，以及与@范冰冰@ 不打不相识的过往，感谢这五年冰冰的坚持，才有200个孩子的手术顺利完成而且健康成长……BTW：像我这种矮挫黑，以后坚决不跟白富美一起出镜了 <  
《最强大脑》让科学变流行的神奇节目！上次在南京录制，现场大开眼界！玩得也尽兴！就是没来得及去吃一碗孟非哥的小面，馋啊！	抱歉，此微博已被作者删除。查看帮助：http:t.cn/Rfd3rQV
放心吧！决不辜负你！	新的一年也要吃不停啊 @范冰冰@ 
不一样的少爷！这种精神难能可贵，很是不易！让人敬佩！加油！	出山前的心聲 我分享了< 
全世界只有一个你，叫我如何不珍惜！@張鈞甯@	 全世界只有一个你，叫我如何不珍惜！ @范冰冰@ @張鈞甯@ @武媚娘传奇@ 系列图三 
惊喜依萌！加油！[带着微博去旅行][带着微博去旅行][带着微博去旅行][马上有对象][新年快乐] @金依萌@:惊喜2月6，一路爱个够！ 快约起来～	【提档2月6日等你来！约！】由@金依萌@ 监制、编剧并联合执导的萌式喜剧《一路惊喜》，提档至2月6日提前引爆除夕潮流新过法！想像@郭采洁@ @蕭敬騰@ @赵丽颖@ @凤小岳@ 等主创展露风格迥异的除夕趴体style吗？想过一个与众不同有着时尚文字标签的春节吗？约在2月6！ 
康永哥的昭君这般丰容月貌、光华倾世！媚娘甘拜下风！	「满城尽是武媚娘，      老子放出王昭君！」 ????????????          ～ 在下多年前为了推广崑曲，(不是为了个人兴趣喔)，扮成崑曲「昭君出塞」的王昭君。。。???????????? 
爱之深，恨之切，撕完了	不忍直視今晚大攤牌的場面，徐姐姐心裡還是在意媚娘的。當初姐妹情愛的多深，這股心中被背叛的痛就有多深，轉為利刃，反過來造成傷害。如果在一開始，大家都把心裡話說了，嫉妒也好、猜測也好⋯如果⋯，只可惜如今為時已晚⋯@范冰冰@ 
美丽的姑娘，人们因你的声音而温暖，在另一个世界继续歌唱	世上少了一位好声音，天堂多了一位歌者。去年在袁总家一起吃饭，你是那么有趣而活泼，之后再没见过。上周跟袁总在香港，他突然改变行程去了深圳，这些天我一直为你祈祷，从昨晚坏消息假消息的煎熬到今天下午，你安静的离开了，去了那遥远的地方，那儿祥和，没有疾病的折磨。姚贝儿，我们会想你 
唯一吻戏？！⋯范冰冰工作室:这位小哥扮相不错，问题还挺深刻 @宥鸣@:去年8月录制，暗藏5个月之后，我们2014压箱宝的节目终于见众生啦~360度见缝插针揭秘@范冰冰@ 片场生活，呃……18分钟的问题是怎么回事？我一定是被徐慧@张钧甯@ 喂了五行草，神志不清才问出来的	《》横店独家探班！< @范冰冰@ @李治廷@ 剧中唯一一场吻戏曝光！凌晨三点@宥鸣@ 乔装成“皇太子”，化妆间、服装室、录影棚一个都不放过！更有“突袭”@范冰冰@ 保姆车、“诈骗”女神曝光手机照片……猛料太多，带你全面揭秘传说中的“一代女皇”——范冰冰。 
破3了，破3了！履行承诺！来！黑????·李打一架吧！ @范冰冰工作室@:8个月寒暑冬夏，8个月兄弟姐妹们的心血凝聚，收视破3啦，媚娘好样的，这前庭后宫都是好样的 我还要告诉你们的是，今天开始她又要再回14岁啦，浙江卫视开播	湖南卫视《》昨晚平均收视已破3，48集单集最高3.6！媚娘，不枉你在宫中受了那么多的苦，更感谢大唐的皇帝皇子皇妃公公宫女们，我们的努力没白费！今晚，浙江卫视也将开播《武媚娘传奇》，还没来得及看剧的小伙伴儿们，你们有福了哟！  @唐德影视@ 
我的杀马特年代！	看见范冰冰杀马特造型，我只能说这是个看脸的世界。  
回陛下，媚娘给陛下跪了 @Shirley酱zzZ@:大荔枝顺拐也萌萌哒 @小天是有求必应的答应@:朕顺拐也很ok的… @卧槽帮帮主@:哈哈哈哈哈哈@无琉子@:哈哈哈哈哈哈哈 @M大王叫我来巡山@:干什么！朕只是有点紧张！@然后下面就没了@: 哈哈哈哈哈哈哈 @活在异次元的竹子@:感觉很可爱哈哈哈	你哪隻眼睛看見朕順拐了！ 
开奖了！@当初轻唤媚娘的谁_贪欢@  @宋沿金@  @歌东歌@   私信我联系方式，上海见！[去旅行]	上次和大家视频聊天没聊够，这次破2000万来点特别的，随机抽取关注并转发评论的三位朋友上海旅游，一起录制，往返三天吃住行我全包，来吗？ 
雉奴登基，媚娘回宫，皇后的宝座，雉奴的专宠，我都要把它夺过来！	周一送福利，新一批武媚娘美图来袭！五张图五个不同场景，你还记得都是啥剧情不？ 
花期将至！	 莫问前程凶吉，但求落幕无悔! @武媚娘传奇@ @范冰冰@ @范冰冰粉丝团@  系列图五！ 
做给自己看！	@蔡依林@ @陳奕迅所長@ @范冰冰@ @edc陳冠希@ 全智贤 超强Superstar组合！Superstar不在乎被多少人观看。做给自己看，不是做给别人看。 @adidasOriginals@ 
哎呀呀呀打错字了，仰天长笑	快来大嘴吧抽我吧！哈哈哈哈哈！（假天长笑中）！ 
能吃有罪吗？有吗？有吗？可有的时候我也是很能[炸鸡和啤酒][炸鸡和啤酒][炸鸡和啤酒][炸鸡和啤酒][炸鸡和啤酒][炸鸡和啤酒][炸鸡和啤酒][炸鸡和啤酒]的！你懂的！[挖鼻屎][挖鼻屎]	【妻子因吃得多被夫打欲跳桥，民警赶将其劝下】1月17日凌晨，因为被丈夫嫌弃吃得多，贵阳一女子在解放西路的五眼桥上准备跳桥。路人报警后民警赶到，将其劝下并送回家。据悉，在麻将桌上妻子吃得多了点，当晚回家后丈夫一气之下打了妻子，能吃有罪吗？你们怎么看？赶紧吃包辣条压压惊！ 
赢了天下，不如你在身边！	【《》热播 武媚娘悲喜人生引唏嘘】2月3日《武媚娘传奇》即将收官，但是热度丝毫不减，@范冰冰@ 饰演的武媚娘开始垂帘摄政，权力几乎达到顶峰，但又再度遭遇丧子之痛，一面是权力上的极致巅峰一面是人生中的挫败连连，两种极端的人生境遇同时出现，让人不禁唏嘘。@唐德影视@ @高翊浚@ 
遇见！	在@萧邦Chopard@ 遇到自己...@范冰冰@  
第一！[带着微博去旅行]	 电视剧20亿剧乐部《武媚娘传奇》网络播放量最高！ 截止2015年1月31日，共有59部电视剧网络播放量超过20亿， 《武媚娘传奇》以93.87亿排名第一 ！@范冰冰@ @张丰毅@ @李治廷@ @张钧甯@ @李解@ @李李仁的微博@ @李晨@ @张庭@ @周海媚@ @张馨予@ @张定涵@ @张彤@ @任山@ @演员孙佳奇@@施诗Kira@ 
好吧！说的也对！对一个女孩好！请动心！❤️	抱歉，此微博已被作者删除。查看帮助：http:t.cn/Rfd3rQV
舍得，舍不得！	 莫问前程凶吉，但求落幕无悔～ 追了一个多月 就快大结局了真心不舍 从初入宫的才人成为一代女皇一段传奇 真的好想画完所有造型啊  @范冰冰@ @武媚娘传奇@ @武则天电视剧百度贴吧@ 
封了！疯了！ @范冰冰工作室@:恭喜武媚娘登上皇后宝座	【《 》热播 武媚娘霸气登顶终封后】昨晚，@范冰冰@ 饰演的武媚娘终于登上皇后宝座，封后大典雍容华贵。今天为大家送上武媚娘封后拍摄幕后花絮，带你到这华丽盛典拍摄幕后一窥究竟。武则天封后拍摄花絮< 海报拍摄花絮< @唐德影视@ 
多多，冰冰阿姨还没开始呢！但是阿姨先看见你啦。	@范冰冰@ 已成为儿子心中女神！????来看看我拍的视频：“儿子中了武媚娘的毒了！天天吵着：多多要看冰冰阿姨！ ????????????”，点此播放&gt;&gt; <（通过  拍摄） 
重庆 重庆 @李玉@:电影梦，你可以实现！ @电影人程青松@:过来去重庆耍！ @导演王小帅@:扎起，巴适	【活动预告】电影和书籍一样，是一扇窗口，也是感知生活的一种介质。#2月8日14:00，《青年电影手册》重庆分享会#将在大坪店举行，届时，本书主编@电影人程青松@ 及嘉宾@冯家妹@ 将会来到现场与大家分享有关电影的故事。关注@重庆购书中心@ 转发本微博并@ 两位好友，抽取3名读者赠送签名书！ 
最后一张是什么鬼 @范冰冰工作室@:收视再创新高！ 27日收视全国网破4！精彩轮番，好戏再续！@武则天电视剧百度贴吧@:范冰冰演技大爆发，今天好多场戏都演绎得特别好，霸气侧漏！	今晚封喉，明晚封后。  
雉奴@李治廷@ 看到那么多人被你的演出感动到落泪，我真的很高兴，你说过你会拼了命努力，去演好这个你爱的角色，决不让我们失望。只有我知道你为此付出了多少！如今，你做到了，甚至比我们想象的还要好！我们真挺为你骄傲的！媚娘。 @Coco_Laurel@:从此提起李治，脑海里就会出现治廷的角色诠释。	 今晚迎来大结局，雉奴从当初的小屁孩变成了郁郁寡欢的老皇帝。卧槽，我也从路人变成了李治的脑残粉，@李治廷@ 的演技棒棒的，从青年到老年的年龄跨度，演活了李治的温和个性，以及对媚娘的痴情爱恋感人至深。人生难得几回爱，如果可以，希望  
人的一辈子就几个十八年，还有三五好知己！	@武媚娘传奇@ 今，华丽落幕！感谢你！。感谢有你！。让我们用十八年的时间亲历和共享了这一人生中的奇迹！。期待，下一个十八年。。@范冰冰@ 
武媚娘立春，收视破五，我想说，从今夜起我武媚娘的人生在浙江卫视@浙江卫视中国蓝@ 才刚刚开始！小伙伴们是不是觉得前九十几集都白看了的感觉？武姐姐这里等你！不删不减！[炸鸡和啤酒][炸鸡和啤酒]	 【喜报】 大结局全国网收视破五！！收视率5.08，市场份额13.68%，再次刷新2015年度电视剧收视新记录！@范冰冰@ @张丰毅@ @李治廷@ @张钧甯@ @李解@ @李李仁的微博@ @李晨@ @张庭@ @周海媚@ @张馨予@ @张定涵@ @张彤@ @任山@ @演员孙佳奇@@施诗Kira@ @王绘春@ （图by@卫视这些事儿@ @biyou2706@ ） 
所有兄弟姐妹们的努力没有白费！我们吃过的苦，流过的汗全都是值得的！快告诉我，下一个目标我们要做什么？只要梦想还在，又怕谁来阻挡！@武媚娘传奇@ @范冰冰工作室@ @唐德影视@	 大结局收视率4.234%，网络总播放量99.8亿！之前一直只给数据，但在结局之日我必须说一句：武皇创下黄金档十年收视率记录！创下中国历史上电视剧网络播放量记录！达到这种收视、网络双爆的程度，中国电视剧史上只有武媚娘传奇做得到，不敢说绝后，但绝对空前！！ @范冰冰粉丝团@ @范冰冰@ 
万物开春一枝柳???? @韩庚@:全都有啊！ @李玉@:说走咱就走啊！	开春第一吼！光怪陆离的医学院、暧昧斑斓的复古范、放肆纠缠的真感情、醉酒打架的好兄弟……当从纸上跃然成影像，它是否如你想象？4月24日任性提档，一起见证虎狼之作！戳&gt;&gt;< @制片人方励@ @路金波@ @冯唐@ @李玉@ @范冰冰@ @韩庚@ @齐溪@ @沙溢@ @吴莫愁Momo-@  <
武则天，今晚！大结局！	【《》今晚收官 武媚娘登基终成一代女皇】莫问前程凶吉，但求落幕无悔！今晚《》即将迎来大结局！曾经的豆蔻少女如今终于达到人生顶峰，终成一代女皇武则天，3D龙袍也终于现身！！不聊了，小宫女跪着发微博呢。。。@范冰冰@ @范冰冰粉丝团@ @唐德影视@ @高翊浚@ 
晓雪姐和Elle的同事们辛苦了！喜气洋洋回家过年！春运期间大家注意行路安全哟！✈️????????	亲们赶着回家过年，我们赶着年前出新刊，让亲们回家的路上有新杂志可以翻。这一期破例提前上市，四版系列迎春封：让桃花般妩媚的媚娘、穿上喜洋洋的红衣、回家贴起窗花、一起开包年三十的饺子——你从来没见过的如此温暖如春的@范冰冰@ ，带着ELLE回家过年喽 photo by@陈漫ChenMan@ 
他念着她长大，男孩只能长大一次… @李玉@:柳青，不是初恋，却改变了秋水的人生。他念着她长大，男孩只能长大一次…	第5天。我第一眼看见她的时候，有一种不祥的预感，我们之间一定会有某种事情的发生。后来我知道，她叫柳青。——《万物生长》原著，06柳青，第041页。@冯唐@ @李玉@ 
美食、美酒和爱，都是女人不可辜负的宝贝。记得保持一颗爱自己的心，一颗爱里的心。❤️	生而为女人，爱自己是一生的必修课, 切莫忘记在每个属于自己特别的日子里用美食美酒奖励自己，随时随地取悦自己。这个情人节，酩悦粉红香槟邀请你用爱得起的自信随心所欲爱自己，绽放独属于你的优雅魅力。 
醉了！弹！弹！弹！ @范冰冰工作室@:这位童鞋的表演惊为天人，颇有吾皇风范呢！Come on，大家一起弹弹弹，弹走霉运，迎来福气[豬頭][熊貓]	妩媚娘之弹走绿茶婊！哈哈哈哈哈弹弹弹，弹走绿茶婊！ (主演：王小强)< 
有意思吗？的意思是那些营销和们，你们这样真的有意思吗？服了！就这点意思还没整明白意思！	有意思吗？ 
支持！那我就等着看什么是没有炫技的表演吧！654！你好！ @李晨@:没有化妆、没有炫技、没有懈怠、在一个北京最冷的冬季体验了一回乡村民警的苦与甜。2月12日央视8套见！大家好，我是654！	【央八剧好看】梦想虽好，现实却未必如意；是非分明，情理未必就能分清。如果生活只给出一道单选题，什么才是他的完美答案。CCTV-8【《》2月12日-2月21日】每晚19:18黄金强档三集连播[玫瑰] “剧情版”宣传片抢先看~< @李晨@@霍思燕@@于越@@赵小锐@@杜江侦察记@  <
百亿大家爱看就是我们最高兴的事！ @范冰冰工作室@:成为电视剧史上第一个网络播放破百亿点击率的剧,真正的传奇！	 收视破五完美收官，截止昨日, 网络总播放量也达到101亿9271万，成为@Vlinkage@ 监测统计到的首部破百亿电视剧，成为中国历史上第一个破百亿点击率的戏，这历史性一刻由我们一起见证。感谢大家一路的支持！真正实现了收视率与网络点击双赢 。@范冰冰工作室@ @武媚娘传奇@ @范冰冰@ 
Valentino新店揭幕，恭祝生意兴隆！	ValentinoHK.晚宴.高清 
浒导，相信慈祥的父在天已经看到，他老人家一定为你骄傲！	< 本该最自豪的春节成了最遗憾的春节.春晚片头,父亲看不到了.只差九天.是一生的遗憾,也是将照亮余生的沧海遗珠.余生每部作品都将献给父亲,余生只为令父之名举世瞩目.余生完结,见到父亲,定能毫无遗憾地说,为我自豪吧.他定会欣慰点头.一定.  <
小冰儿也觉得这事儿靠谱，咱三个好好合计合计@林心如@:在在在*~寶貝兒,你負責導,小冰兒負責制作,跟帥哥談戀愛這種麻煩事就交給好了@赵薇@ @范冰冰@ @赵薇@:哇！白嫩白嫩滴呀！想念大明湖畔的夏雨荷了@林心如@ 下次咱三个再拍一套戏，有人看吗？	结识薇时正豆蔻   重逢冰心在玉壶  @赵薇@  
哇 这么神奇的巧合今儿大年三十，大伙儿都在哪过年呢？多陪家中老人，多吃饺子得元宝，媚娘给大家拜早年了，祝各位千事吉祥，万事如意！[大红灯笼][大红灯笼][大红灯笼]	624年的今天，中国历史上唯一的女皇帝武则天出生。2015年的今天正巧是@唐德影视@ 上市的日子，更巧的是唐德影视的股票代码正是300426，种种的机缘预示着唐德将像武媚娘一样书写下永不落幕的传奇！ 
我也会唱了！ @谢娜@:太！好！听！啦！我！会！唱！啦！	<  
恭喜唐德影视成功上市，股票涨停！[大红灯笼][大红灯笼][大红灯笼]作为团队一员，见证这一刻，倍感荣幸！老友相聚，莫大的欢喜！这是我们的新起点，我们的骄傲！恭祝大家的新年红红火火！福禄寿禧来！[羊年大吉][羊年大吉][羊年大吉]	恭喜@唐德影视@ 十年磨一剑成功上市，一帮有智慧有理想的年轻人团队，未来将会打造出更多好作品奉献给观众！春节将至，喜气洋洋，团队最全的一次大聚会，更是老朋友叙旧重逢畅聊的好日子！春节将至！祝新年新气象，更上一层楼，为永不磨灭的理想。@范冰冰@ @kent_zhao@ 、吴宏亮  
有梦想的人，总是充满了动力！加油！	謝謝你的欣賞 < 
六相里都是我又都不是我！谢谢杂志社的同事们给了我一次特别又难忘的拍摄！很喜欢！辛苦了！	第191期《红秀GRAZIA》:【“六相”范冰冰】在GRAZIA六周年之际，我们以六种独特的方式，试图呈现颜值爆表、智商超高、拼劲异乎常人的@范冰冰@ 多个侧面，结果证明—— 范冰冰还真的是一切皆有可能！Photo by@陈漫ChenMan@ 编辑@CELINE_WANG@ 造型@露哩露哩露哩@ 化妆@胡議尹@ 发型@化妆师高建@ 
我就是红秀六年不离不弃的红粉！@孙哲GRAZIA@:六周年封面提前曝光，回馈一直不离不弃的红粉们！而冰冰的“六相”演绎，简直是喜上加喜。@红秀GRAZIA@ 最懂范冰冰，而范冰冰也是@红秀GRAZIA@ 最称赞的女艺人！赶紧把欢乐转发出去，@红秀GRAZIA@ 与范冰冰祝大家，新春快乐，恭喜发财	第191期《红秀GRAZIA》:【“六相”范冰冰】在GRAZIA六周年之际，我们以六种独特的方式，试图呈现颜值爆表、智商超高、拼劲异乎常人的@范冰冰@ 多个侧面，结果证明—— 范冰冰还真的是一切皆有可能！Photo by@陈漫ChenMan@ 编辑@CELINE_WANG@ 造型@露哩露哩露哩@ 化妆@胡議尹@ 发型@化妆师高建@ 
你这个磨人的小妖精	分左邊、分右邊，傻傻分不淸楚～嘻！連髮型都這麼有默契～@范冰冰@ 
请让更多人看到。	《穹顶之下》纸版演讲，内嵌图片视频。大象公会出品。晚安。 < 
 @姚晨@:	如何拨打12369环保举报电话，细心志愿者流程说明。赞。 < 
圆圆满满 潇潇洒洒	句号。圆圆的。 
迎财神去哪？你们不知道吗？他自从进了范冰冰工作室，就再也没出去串过门儿[羊年大吉][马到成功]	财神到，财神到！正月初五迎财神，恭喜发财！据说转发此微博今年都能发大财！[爱红包][爱红包] 
春今晚的表演好看 好听????	 一针一线一曲吟，一家一城一国情。全息投影打造炫目舞美，清歌华服演绎唯美《蜀绣》。一曲动情，今宵难忘！ 
柳青又何尝不是呢？	秋水的人生充满了未知。。。 
走！为民除害去！ @韩庚@:今天变身谈恋爱！ @李玉@:一辉跟雅典娜吗？柳青秋水你们这样玩儿…太好了！	秋水柳青玩变身！奔跑吧万物生长！@范冰冰@ @韩庚@ 
润物，无声。	惊蛰，海报。 
吃你！吃你⋯⋯元宵节片不吃元宵了，就吃你！ @李玉@:就这么吃你，用所有的牙齿和所有的记忆…骚情歌，献给骚情的你！万物生长，来了！	【同名风骚MV】原著@冯唐@ 亲自作词，@宋冬野@ 作曲并演唱，@范冰冰@ @韩庚@ @齐溪@ @沙溢@ @吴莫愁Momo-@ 走过教室宿舍课堂，生猛演绎青春民谣，同时曝光全新澡堂放肆湿身片段。稠稠地/急急地/狠狠地，这个元宵（sao）节！！@李玉@ @制片人方励@ @路金波@ MV猛戳&gt;&gt;<  <
今晚八点????看明哥???? @黄晓明@:今晚八点湖南卫视。转发的人发大财桃花朵朵开！	 今晚8点，湖南卫视金鹰独播剧场，暖春迷情风云再起，一场爱的华丽冒险壕情献映@上海泓霆影业有限公司@ @环玥@ @一哥黄斌@ 
我要去看！????????????	萌宠小熊来到中国  明天由星美影业嘉映影业购入华夏发行的阖家欢电影《帕丁顿熊》将在上海首映了 很荣幸这次能够请到威廉王子光临 王子将亲自推荐这只可爱的小熊给中国观众～～感谢！之前给大家寄的帕丁顿熊玩偶想必也都收到了吧 没收到的举个手～ 
哈，长江后浪推前浪⋯⋯ @李晨@:“李晨 OUT…”你赢啦，加油张艺瀚。	我记录了一段约架：“情敌见面 分外脸红”，@李晨@ 分享给你们哦~ <（使用  录制）  
我要用尽万种风情，让他在未来不和我在一起的时候，内心都无法安宁！ @李玉@:青春时期的爱情，炸点真多，爱的直入骨髓，烈，像酒！ @韩庚@:始终不放弃，对生命和爱情的希望！来吧！！！	【预告片】女神@范冰冰@ 化身性感“猛虎”，用尽万种风情，引青春“头狼”@韩庚@ 释放荷尔蒙。这场凶猛“虎狼之恋”里，韩庚饰演的骚男秋水更被@齐溪@ 范冰冰两人轮番狠抽！别样躁动的青春，荒唐放肆的爱情，原著@冯唐@ 导演@李玉@ ，4月24日一起生长！凶猛预告戳&gt;&gt;< 
这是秋水与柳青的爱情。@韩庚@ @李玉@	 曝光范冰冰韩庚新剧照，4月24日看柳青秋水的重口味青春！ 
简洁而先锋！这一季依旧美得独特！	巴黎时装周的最后一天，路易·威登的压轴大秀，范冰冰与路易·威登创意总监Nicolas Ghesquière秀场合影，一个英俊的设计师和一个酷酷的灵感缪斯，这场面怎一个“帅”字了得！感谢摄影师小方 @ffflyy_FANG@  
打开录音机 打开唱片机 你能听到我的心在咚咚跳 别再问我什么是八十年代 什么是迪斯科！	巴黎时装周最后一天，Louis Vuitton 2015秋冬压轴大秀，@范冰冰@ 来了！@小黄少@ @卜柯文@ @胡议尹@ 
回复@瘦成一根小竹子@:四川农业大学的同学些，你们好得行哦！是真的恁个想我去哇？梦想还是要有撒，万一实现老唉？@瘦成一根小竹子@:四川农业大学成都校区来来来????????????	春暖花开，万物生长， 要开学了！突然想重回校园，和同学们一起感受开学的氛围！转发此微博，说出你所在/毕业的学校，下周我会根据大家的热情程度，选一所学校，和同学们一起玩耍！快敞开怀抱迎接我吧！ 
草裙舞！ @陈砺志@:这种假新闻港媒报道一下也就罢了，国内媒体这点判断力都没有？按总制作费3亿算，96集，平均一集总费用不到300万，如果冰冰一人拿2400万人民币，是说其他演员都倒贴2000万来演的？然后每集没钱买服装只能跳草裙舞？	【曝范冰冰片酬1集3000万人民币】据台湾今日新闻网报道，香港 《好报》杂志，获得一份极机密的大陆女星、拍电视剧酬劳名单，其中排名所有女星之首的，正是 《武媚娘传奇》的范冰冰，她以一集3000万人民币 ，外加分红以及电视广告收益，分分钟进帐逾亿，成为“2014”剧后当之无愧。< 
乱入 @卜柯文@:冰融之时，方能绽放	一切美好的东西都永远存在，她们只是像冰一样凝结，而有一天会像花一样绽放---冬日午后，融雪的冰@范冰冰@ ❄️❄️ @路易威登@  PS:图九：大咖造型及设计师@卜柯文@ 乱入ing 
给整理资料的小伙伴手动点赞！[贊][愛你] @范冰冰工作室@:DUANG！DUANG！DUANG！哪里都是你！@范冰冰@	范冰冰DUANG地一亮相，就承包了各大外媒版面！同是中国人的我，也感觉灰常傲娇呢！ 
巴黎到处都是复古的浪漫味道，我为它醉了[愛你] @范冰冰工作室@:复古范，别样美[花心]	@范冰冰@【执着复古的范小姐】橙底燕鱼长袖连衣裙与橘色热带鱼连身裙 @ChristopherBu@ 2015 春夏 @卜柯文@ 深色手袋与褐色大衣@路易威登@ 腕表与戒指@萧邦Chopard@ 编辑 @王小豆子@ 拍摄@章元一@ 
快买下一块支持我！[懒得理你][懒得理你]	抱歉，此微博已被作者删除。查看帮助：http:t.cn/Rfd3rQV
梦想中的大衣！	之冰冰穿我的大衣很帅！@范冰冰@ 
爱到深处自然黑！节目马上开始喽！[炸鸡和啤酒]	姑娘，你是忘记吃药了吗？[挖鼻屎] 
想来就来吧！	@范冰冰@ 在展览中的灵感之旅，跨越了路易威登“过去-现在-未来”，穿梭于不同时空与主题。即日起至4月12日，该展览将于北京国贸商城西楼路易威登之家举行，您也不妨前去观赏？ 
喜欢！多少种穿法我数学不好别问我 @范冰冰工作室@:每种颜色都代表一种好心情！穿上它们，感觉就像是踏着七彩祥云呢！[擠眼][擠眼]	 [花心][花心] 感谢 @adidasOriginals@ 给冰冰的礼物 [花心] 7个颜色刚好1天1个颜色！还可以混搭穿 [花心][花心] 那么问题来了，混搭7种颜色有多少种穿法呢？ @范冰冰@ 
北京的展览开始了,大家去看了吗？非常棒的体验！还有手工匠人现场展示硬箱的制作过程，称奇，难忘！ @路易威登@:@范冰冰@ 亮相展览揭幕酒会。	   @范冰冰@ 现身“@路易威登@ 系列二——过去、现在和未来”展览开幕红毯。 
该拥有一切，却又该只属于一个人。喜欢这句。 @范冰冰工作室@:誓要用万种风情，让你们都无法安宁！	今天看到一段话，便想起了一个人。万种风情，眉目千回。「她该被人爱，被人恨，被人捧在手心里，被人埋在脚底下。她该被攻陷，该被占有，她的眼睛里有一个别人看不见的星河。她该万众瞩目，荣华等身；她该拥有一切，却又该只属于一个人。」是还是@范冰冰@ @电影万物生长@  
你们千万别救我！因为我发现我好像也 得了桃花癫！[挖鼻屎]但我不想吃药，万物生长的季节，可能癫癫就好了！@谢磊xl39@:@金俊秀0fficial@:我现在竟然也开始对范冰冰照片傻笑了有点不对@vivi回转@: 同治@ilJunnn@:哈哈哈哈哈我也有这病！得治	【小伙抱范冰冰照片傻笑不止 系患上桃花癫】近日，厦门一名23岁的小伙子把家人急坏了，他不仅不上班，整天还捧着@范冰冰@ 的照片不撒手。两天两夜不睡不说，还自言自语手舞足蹈，时不时发出傻笑声。经医生诊断，确定他是俗称“桃花癫”的躁郁症发作，用药后已稳定…… < 
醉青春！	【海报】“二十岁的时候，以为眼前的一切都会永远”。当秋水@韩庚@ 手执酒瓶，与宿舍兄弟@杨迪@ @张博宇MoxiRescue@ @赵一维@ 一醉别青春时，我们仿佛看到了曾经迷茫的自己。青春，不在于怀旧的物件，而是情感的真实。当他迈过那个万种风情的女人@范冰冰@ ，才会迎来真正的成长……戳大图↓ 
开始工作了！我们加油吧！	[GIF] 跟着我的节奏一起，动次打次动次打次摇起来... 
喜欢你的真实，请记住我们的约定，时装周带你走起！[贊][贊] @出彩中国人@:从初出茅庐到收获认可需要不懈的坚持与努力，从自己奇思妙想到走上时尚时尚最时尚之路，或许还差一个摩擦摩擦去时装周的距离~《出彩》撑你！冰冰，你说是吗？@范冰冰@	导演说，今晚20点05分央视一套《出彩中国人》就要播出了，问我害怕吗。我说我不怕，因为我在台上说得都是真实的。就像冰冰姐说的，我经得起多大的诋毁,就能承受多大的赞美 。@范冰冰@ 我一定会记住我们的约定。 
那么多重要的事，都与你有关。	姑娘说拿去表白（笑）那就再借一番姑娘的话了。＂我不是来攻城的，我是来倒戈的。这些分输赢的在我眼里，都不是那么重要。你重要。你跟我在一起重要。那么多重要的事，都与你有关。＂#4.17#@范冰冰@ 
没有人比你适合，我就要听有营养的对谈！ @李玉@:其实特不想参加深谈节目，我是个掩饰力极差的人，不小心就会把心里话给冒出来了，不适合，真的不适合。	【预告】导演@李玉@ 同@制片人方励@ 一起做客优酷@老友记Friend@ ，才女导演对话金牌制片，畅谈《万物生长》的方方面面，超多精彩幕后花絮，敬请期待！ 
“魔范学院”可以下载啦！周末啦，游戏玩起来！扫码吧！	DUANG！！4月2日“魔范学院”开学典礼！卖得一手好，逗得了歪果仁，这样的导师范小胖你们还喜欢吗？记得来魔范学院报道，小胖导师随时敞开大门欢迎各位同学！扫码扫码扫码吧！@范冰冰魔范学院@  @掌上纵横@ [愛你][愛你] 
时光逆流 五一见面！ @黄晓明@:宁愿孤独终老，也不爱的将就。时光逆流版预告，5月1日	【首款预告片发布】这七年，我被长夜啃食，我把思念咬碎，多少次下了决心，若再见，我定要叩问你的心，为什么要走，又为什么回来。爱是梦一场，我多希望梦醒时分，你还在，草地还是绿的，吻还是热的。赵默笙，你听着，这一次，我绝不会再把你弄丢。 < 
自导自演的吴京作品 支持！	明天4月2日《战狼》全国公映！专治各种不服！不开玩笑！ 
417，爱情，不愚人，电影院等你！ @李玉@:虽然是愚人节，但我们从不愚人！417，电影院等你！	【】《万物生长》主题曲mv及@范冰冰@ @韩庚@ 春光海报双双温暖上线！听着韩庚@张靓颖@ 温润的曲调，望着秋水柳青炙热的眼光，春光和爱早就按耐不住等待，所以提档了！4月17日全国公映！4月15将在部分城市举办点映。是真的！因为爱情，从不愚人。主题曲&gt;&gt;<  <
历时三年《道士下山》期待！	@陈凯歌@ 最新力作《道士下山》首款预告火力全开，并正式定档7月3日暑期档，影片集结@王宝强@ @郭富城@ @张震@ @林志玲@ @范伟@ @演员元华@ @王学圻@ @VanNess吳建豪@ @陈国坤@ @林雪@ 等各路明星，不仅有奇人奇事、奇景奇技，还有的奇情美欲，不信，你看。< 
祝新浪娱乐15岁生日快乐我们永远在一起	我们在新浪娱乐15岁生日趴体现场！ 
＂那是爱，那是癌，那是如来。＂ @范冰冰工作室@:青春里所有残酷的、极致的，柳青都会在这个万物生长的春天，向你娓娓道来。 @电影万物生长@:柳青@范冰冰@ ——“她来不是为了证明她，而是为了证明你！”	< ★★★★，残酷青春不是浪漫青春。虎狼范爷登场，目的不是为了秀逆光、校园、白球鞋的。范爷在本片中的美是内地青春片中从未见过的一种呼吸起伏都散发诱惑魅力的美。她来不是为了证明她，而是为了证明你！@微影迷@ < 
嘿嘿！谁是胖子？你们全家都是胖子！[花心]@卜柯文@  @范_Knight@:范爸爸，卜大，光哥…有你们三个在胖子身边守护她真好	三个好友！看第二张远处微笑的光哥，是不是一下暖到了心里；看第五张范爸爸拥抱范爷，范妈妈温暖的嘱咐范爷，光哥静静的看着这一幕，很感人！这个世界就是这样，除了父母家人，最真心对你的就是亲近的好友！祝福范爷、卜柯文、大光哥三人友谊地久天长. 
我不要天上的星星，我要尘世的幸福。”  @李玉@:冰冰的美是率真的，是有情感的！ @电影万物生长@:“范冰冰正是抓住了柳青的人物精髓，美，美到极致，骚，骚到骨子里，淡，淡到纯清如水。如果说，李玉导演的作品是流水的男主角铁打的范冰冰，那么，可以说范冰冰是最为诠释李玉作品的女演员。”	<★★★★，我发表了《万物生长》的影评 < 
 @范冰冰工作室@:“不管你有没有说过我坏话，这对我不重要，因为说过我坏话的人不止你一个，很多人说过，但这些我都不会放在心上。我说过的承诺不会变，我们仍然要一起去时装周，我承诺你的我都会做到。我们一定要与人为善，因为我们是女孩，我们要有最柔软的一颗心，去对待所有好和不好的事情。”	花絮：王守英自爆骂过范冰冰，女神回应“不在乎”  PS：换造型了很美的说。<  <
皇帝的新歌！ @李治廷@:小L老師美容教程：循環聽GODA，釋放你的魔性，笑開你的魚尾紋???????? @李治廷花样盛世资讯台@: 今日上线，皇桑出手，必须洗脑[甩甩手][甩甩手][甩甩手]小伙伴赶紧安利起来～[转发][转发][转发]	热播节目主题曲《GODAGODA》正式发布！歌曲由“挑夫”@李治廷@ 包揽词曲创作，更纳入了@林志玲@ 标志性的“加油”和雪姨@演员王琳@ 的经典“开门”，不但歌词朗朗上口，曲调更被称为极具“魔性”，让人听着就想大跳广场舞！小编已被洗脑试听点击：< 
青春本就是一件形势大于内容的事！对不？ @制片人方励@: @范冰冰@ @韩庚@ @李玉@ @冯唐@ @电影万物生长@	 导演为柳青和秋水解读回放视频：1、愉快观影 2、还不错吧？ 3、有点不对…4、谁在搞鬼？5、我早就说过… 6、一个人干活受罪 7、男女搭配干活不累 8、我说的对吧？9、你们看，冯唐在小说里就这样写的  
你说，我们应该是先扯个证呢？还是先怀个孕呢？	[纠结][纠结][纠结]看完海报，脑海里浮现出一个医生，她给每一位病人都开了一张的电影票………????????????????@范冰冰@ @韩庚@ @李玉@ 
收工了，卸了妆，总想再听一遍！到底有多少爱可以重来？为了让我们从此不遗憾，不后悔，不纠结，不难过，请珍惜好我们的眼前人。	【】《万物生长》主题曲mv及@范冰冰@ @韩庚@ 春光海报双双温暖上线！听着韩庚@张靓颖@ 温润的曲调，望着秋水柳青炙热的眼光，春光和爱早就按耐不住等待，所以提档了！4月17日全国公映！4月15将在部分城市举办点映。是真的！因为爱情，从不愚人。主题曲&gt;&gt;<  <
做自己才是人生最美妙的状态！加油！	感谢冰冰姐@范冰冰@ 帮我澄清 我会继续做自己 继续努力——靠自己！ 
这首歌曾结结实实的打动过我！ @范冰冰@:我想说，孤独的人是可耻的。	【预告片】张楚轻轻吟唱，经典摇滚诠释青春，流动的电影画面+醉意的人物独白+浅吟的诗意歌词，让情绪流缓慢淌，让爱情肆意疯长。这万物生长的季节，男神@韩庚@ 女神@范冰冰@ 喊你“必须恋爱”！！听后暖暖沉醉，戳&gt;&gt;< 我们，约！ 
万物生长炸校园，好玩儿了！[花心] @本宫要去幼儿园深造了@:川农大学生好热情	成都。川农的热情点燃了万物生长的青春！跟火锅说声再见、跟麻辣烫互送离别，驴打滚我们来了！@制片人方励@ @李玉@ @范冰冰@ @韩庚@ @齐溪@ @杨迪@ @张博宇MoxiRescue@ @赵一维@ @四川农业大学@ 
我们俩吗？！ @李玉@:越来越近了！	倒计时3天。预告一下，明天干大事！ 
超前超前超前点映！ @韩庚@:4月15日，抢先看起来！	虎狼下山，提前开嗨！4月15日，本周三晚19点，全国300场超前点映！8大电商，11座城市！猛戳链接，感受里混蛋逗比的青春吧&gt;&gt;< 18元抢票传送门，网页购票&gt;&gt;< 手机购票&gt;&gt;< 
十里春风，不如你俩，请来看首映吧！ @李玉@:似曾相识的是风，是味道，是春风十里，彼此相爱！	一切是那么似曾相识，就像记忆里的风，成长也是有味道的，因为万物皆有。四月十七有部好电影，戏文儿里他说十里春风，我说不如你！她说为民除害，你说要不要相爱！ 
这么严肃的一场戏都被你们玩儿坏了！	【喜剧版预告】虎狼出山！“坏男”秋水@韩庚@ 遇上“女神”@范冰冰@ ，并周旋在现任女友@齐溪@ 之中，青涩的囧态+微妙的滑稽=爆棚的喜感！福尔马林的医学院、不靠谱的师生，让这最春的小说与电影更显喜感十足@冯唐@ @李玉@ 。抢先嗨翻？4月15日300场点映！喜感预告&gt;&gt;< 
小沐杨，待你写完作业，来教姐姐数学可好？	小萌娃出彩课堂开课喽！五岁“小天才”@金沐杨2009@ 教你流利背诵圆周率，四位数以上的加减心算更是“秒杀”波波老师手中的计算器。面对“天才”与“呆萌”并存的小选手，“萌娃控”范冰冰多次激动放话：“沐杨你不要算了，跟我回家好不好？”@长安汽车@ 
专收东哥这种萌且帅滴叔！ @演员郭晓东@:范爷，魔范学院收大叔学员么？ @范冰冰@:万物生长热映中，魔范学院玩起来有电影票送哦！	#青春范，万物长#校长@范冰冰@ 请大家看电影啦！10000张电影票来袭，每日抽取2000张，总会抽到你的！具体规则详见活动海报。安卓手机看这里<，苹果手机AppStore搜索“”就可以下载啦！！大家行动起来，动动手，票就是你的啦！！！@范冰冰工作室@ 
走起！为民除害去！ @韩庚@:冲锋吧，万物生长！ @李玉@:奔跑吧，万物生长！	《奔跑吧兄弟》+《万物生长》=！4月17日，强强联手，一起奔跑。@范冰冰@ @韩庚@ @邓超@ @angelababy@ @李晨@ @郑恺@ @陈赫@ @王祖藍@ @包贝尔@ 
万物生长热映中，魔范学院玩起来有电影票送哦！	#青春范，万物长#校长@范冰冰@ 请大家看电影啦！10000张电影票来袭，每日抽取2000张，总会抽到你的！具体规则详见活动海报。安卓手机看这里<，苹果手机AppStore搜索“”就可以下载啦！！大家行动起来，动动手，票就是你的啦！！！@范冰冰工作室@ 
不是我干的！	★★★★★，一部看了可能会怀孕的电影。 
谢谢！	< ★★★★★，你的红唇如火焰在燃烧，你的黑发如汹涌的浪潮。你赋予了柳青生命，柳青点燃了你的风情。，是这个春天，第一部让我落泪的电影。你是这个春天，我唯一想要拥抱的人。你是影后，长情，更常青。< 
会跳水母舞的文艺青年写的真好！青春过往里的那个人，有时飘飘渺渺，但一直都在！ @李玉@:写得真好！	以为年少轻狂的过往都已如烟散去，可总会有些事物可以将你抽离，然后你就像见了老街坊一样无所遁形。那天、开着车、流了泪、说不清的喜悦忧愁；回家、半杯酒、一缕烟、却只想找个肩头；一个电影话出一段人生！那年夏天，。医学院走廊，谁记得，低下头嗅到的芬芳，抬起眼是不变的双眸。 
今晚有人去看零点场吗？ @韩庚@:冲锋的时刻到了！???? @李玉@:冲锋的时刻到了！	明天就是冲锋战场的日子，《万物生长》的小伙伴们满血上阵，背水一战… 亲爱的朋友们，请你们帮着转发，为我们助阵，老方拜谢大家了 @电影万物生长@ @李玉@ @范冰冰@ @韩庚@ @齐溪@ @沙溢@ @李梦VIVIEN@ @吴莫愁@ @杨迪@ @赵一维@ @张博宇@ @沈婷婷@ @张靓颖@ @路金波@ @冯唐@ 
青春的旅途没有红灯，执着不会辜负你的单纯。好听！好看！加油！好朋友！ @赵薇@:走过青春，拥有故事，你的故事很动人！听到不一样的声音！加油！好朋友！期待4.24让你，再.见.青春！	感謝青春的路上有你。@赵薇@ < 
时间像果冻一样在我们周围凝固、黏稠、透明而富有弹性。我们是如此遥远，彼此抱着的仿佛是一个幻象。	4月17日，就在明天，来了！ 
满！希望更多的朋友能看到 明天再战！	对不起，今天又满了。 
我们彼此相爱，就是为民除害今天你看了吗？	 最初的诞生，和最后的死亡一样，都是人生的必然，当未来的某一天，生命被我们挽救，这是我们遵循了你们的教诲，始终不放弃对生命的希望！<（使用录制）  
秋永，你演的抽水特别好！[呵呵] @韩庚@:超哥，你觉得我演的秋永咋样？	抱歉，此微博已被作者删除。查看帮助：http:t.cn/Rfd3rQV
噗哈哈哈哈哈韩红放开那只冰冰@李玉@:我对这俩人做了什么？ @韩庚@:你演的是4.24上映的《万物生长》，我演的是4.17上映的《万物生长》	该微博因被多人举报，根据《微博社区管理规定》，已被删除。查看帮助：http:t.cn/Rfd14WY
别酱！怪不好意思的！[挖鼻屎] @电影万物生长@:“铁腚公主”。万物君悄悄说，电影里也有一个类似的桥段，大家知道是哪段吗？！	第一次看完整的奔跑吧兄弟，看范爷去的，范爷的屁股灭了所有的葫芦娃 
还没看的赶紧走起，再晚就买不到票了喽！周末必须！	不要问我周末怎么过，周末必须看，就是这么任性！ps:有没有觉得范小胖的花裙子真的好有万物生长的feel @aliceandolivia@ 
春雨不断，缠绵如愁。人间四月，万物生长。一句电影好看就是对我们最大的褒奖，希望你们在电影院有一个愉快的周末时光。	《万物生长》上映第一天，女神柳青@范冰冰@ 被赞到爆。她的美从不仅是流于表面，万种风情里的每一种，都是美的诠释。所以！再不去看就out了！！（人人都爱女神） 
舍不得剪染烫，就戴上Rebecca美美地出门吧！[呵呵]	发型随心变，有了Rebecca，想怎么任性都可以！冰冰与Rebecca的合作总是充满美丽和快乐，这次的拍摄就像是进入一场童话梦境，美得不像话！感谢@瑞贝卡时尚假发@ 带来的创意火花！[太開心][太開心] 
不是醒了，是还未入睡！收工快乐，你们早安！	在每一个清晨里！ 
学霸放学别走！ @韩庚@:那位说小黄片的哥们，你过来我保证不抢你的爆米花！	昨日北大清华学霸观影全纪录！——“听说是小黄片”、“好像是生物片吧”、“我们清华男才没这么弱”，全场大笑39次、小笑52次！“女神”范冰冰突然惊喜亮相，让刚才正襟危坐的学霸们瞬间更不淡定了，边尖叫着边纷纷从后排直接跨栏到前排……视频真相&gt;&gt;<  <
感谢支持！电影好看吗？ @范冰冰工作室@:[太開心][太開心]雷迪斯 and 乡亲们，电影好看吗？ @电影万物生长@:谢谢支持，感觉棒棒的！	【顶固衣柜包场力挺范冰冰《万物生长》 就是这么任性】顶固衣柜为力挺形象代言人范冰冰，自4月17日《万物生长》首映以来，特在北京、深圳、成都、南京、郑州、合肥、兰州、沈阳、芜湖、广州、重庆等全国多地高档影院进行包场助阵，举办顶固衣柜专场观影会。@顶固中国@ 详情点击：< 
青春不是病，回忆起来真要命！	『MV首播』@电影万物生长@ 插曲MV来啦 MV→→< 看过电影的同学们，是不是一直在找这首歌！好好听！每一个细节都充满诚意！好唯美！万物生长继续加油！< 
何以琛！别欺负我们家秋水了????@韩庚@ @韩寒@:何以笙箫默，先把狗放过 @后会无期马达加斯加@:你把我的脑袋摁到哪了？	谢谢韩寒家的马达来支持何以笙，所以我也决定支持一下韩寒主演的万物生长！@韩寒@ @范冰冰@ @万物生长@ 
Ever since we loved @李玉@:很多网友问我这首歌儿，它终于来了！	有些电影，每次想起，它的原声配乐就从四周涌来，比如《关于莉莉周的一切》，比如《万物生长》里那段落日戏。感谢小林武史为我们创作的这首《Ever since we loved》，迷离歌声诠释青春岁月的欢乐和忧伤。我们将秋水的三段爱情在MV中呈现，希望你能喜欢。静听&gt;&gt;<   <
 如果世界上曾经有那个人出现过，其他人都会变成将就。@黄晓明@:@一哥黄斌@:终于等到这一天。	【“不将就”版终极预告】倒计时这么多天，终于到了最后一天，我们说了很多话，但这句话最重要：如果世界上曾经有那个人出现过，其他人都会变成将就。而我不愿意将就。4月30日，一场不将就的爱情，一部不将就的电影。@猫眼电影@ 购票请猛戳< <  <
这是一部好电影，这已足够！我们表达了我们内心真正想要表达的一切，这足足够了！我很满足！	抱歉，此微博已被作者删除。查看帮助：http:t.cn/Rfd3rQV
训练的日子像在学校，感谢有这么多同学的陪伴，难忘！	@詹瑞文@ ，香港舞台表演大师，此次在拍摄之初，他将多年舞台戏剧经验教授给主创。表演其实是发现自己最真实那面的过程，演员们在特殊的训练中，不断发现表演的真谛和技巧，在通过了即兴训练、语言训练、角色扮演训练等关卡之后，明显感觉韩庚像是变了一个人，演员之间的火花也更明显更自然！ 
好幸福的你们！	大头大头，吃喝不愁！每个月都会准时收到@petplan派特谱兰@ @自由的狗人@ 送给@范冰冰@ 萌宠们的定制大礼包！大头你造吗？再胖下去范麻麻就抱不动你了???????? 
快来快来！求偶遇	这是哪家的花姑娘？快领走！阻塞交通了啊喂！@路易威登@ @ChristopherBu@ 
明年的夏至未至，不再悲伤逆流成河，告别小时代，迎接最美最疯狂的——《爵迹》。我来了。	 2016年夏天最疯狂的梦境，万千美丽无以伦比。梦境里最美的，是你。@范冰冰@ 
开局！	【《》TVB首播平均收視23點】@范冰冰@ 主演的內地劇《武則天》一連七日無間斷在TVB夜晚9點半時段播出，昨晚周日首播平均收視23點（約149萬人觀看），最高24點（約155萬人觀看），同上周同時段金像獎頒獎典禮收視23點相比，無升跌。同晚的《》大結局平均收視24點：< 
这是为什么为什么呢？央视一套正在播出！	 啊呀呀，节目现场发生了什么让三位评委为何如此激动？！[啦啦啦啦][啦啦啦啦]官微君在这里要卖个小小关子~出彩初选收官之夜即将到来，各位看官一定一定要锁定《出彩中国人》唷！ 
我真的抱的动！????给个出彩吧，今天晚上只为你们加油！❤@出彩中国人@	 范冰冰又玩嗨了！又是秀力量，又是赤脚上阵的记得今晚20点锁定CCTV1，中间那张是陈红 
生日快乐！妞！幸福！勇敢！爱！	谢谢谢谢我最最可爱的朋友们，谢谢大家的祝福，我把所有祝福都回送给你们????????????看到了好些你们送我的视频，很喜欢，和大家分享一个啦，<  爱你们  <
最有气势的中国军团！???? @angelica张宇@:最有气势的一身！祝贺@范冰冰@ 和@@卜柯文@ ！	 @范冰冰@ 这回穿上了“紫禁城”！这件@卜柯文@ 打造的Christopher Bu定制礼服从色彩、工艺到寓意都“中国”得彻底，难怪今天冰冰演绎得气势夺人呢！< VOGUE MINI Met Ball更多独家报道：<  
吃吃吃！买买买！	这俩宝贝@赵薇@ @范冰冰@ 太能逛了，暴走纽约十几条街完全停不下来，我要先找咖啡厅歇了，你们继续期待明天的 
李先生，你确定你这个样子像个26岁的人吗？	大王派我来巡山…???? 
陛下 今晚看你了！	别再等～《真正男子汉》超“燃”预告片重磅首发 --  小伙伴们速度围观了~ < 
晚安！甜的夜。	油画中的少女！???????????? @范冰冰@ < 
酸！ @卜柯文@:就这样我们走过快10年了，你还是如初见你时那般的美好	【独家专访】@范冰冰@ 说今天的红毯造型只用了1小时20分钟，因为跟造型师 @卜柯文@ 配合了近10年，非常有默契。自己其实不经常参加综艺节目，参加跑男是因为要宣传电影《万物生长》，但是跑男真的累死人了。 @巴黎欧莱雅@ 
看电影????	第二天在戛纳，范冰冰助阵电影《MAD MAX：Fury Road》首映礼。油画中的仙子????????Go！@巴黎欧莱雅@ 
李先生，大王今天没有派你去巡山吗？ @李晨@:给女神点赞 @范冰冰@:戛纳 傍晚	 第68届戛纳电影节开幕式，冰冰身着Ralph&amp;Russo为范冰冰特别定制礼服，Chopard高级珠宝，出席盛典。 
戛纳 傍晚	 第68届戛纳电影节开幕式，冰冰身着Ralph&amp;Russo为范冰冰特别定制礼服，Chopard高级珠宝，出席盛典。 
喜欢韩红姐新歌《一个人》，献给自己心里喜欢的那个自己！一个人买来面具假装着强悍，笑着跳着人海里！一个人的委屈难过时，别忘了抱抱自己！	抱歉，此微博已被作者删除。查看帮助：http:t.cn/Rfd3rQV
开心，最好的礼物！ @范冰冰工作室@:感谢大家的喜爱，媚娘的传奇不说再见！	《武媚娘传奇》香港、台湾收视再创新高！香港收视稳居TVB所有剧集之首，收视飙升至29.49点，有26%的人在收看这套剧集。台湾中视、中天收视率分别为1.36（收视总人口约67万人）和0.51（收视总人口约37万3千人），二者相加，收视人群数量已达百万。媚娘的传奇仍在延续，不说再见！ 
彩虹！	今天@出彩中国人@，总决赛，冰冰穿ZHANGSHUAI彩虹折纸系列出现，美@范冰冰@ 
最近迷上了这个秘密武器，每天不离手你知道是什么吗？@巴黎欧莱雅@	抱歉，此微博已被作者删除。查看帮助：http:t.cn/Rfd3rQV
好看的！嘻嘻！	@范冰冰@ 出席萧邦戛纳Trophée Chopard晚宴 @萧邦Chopard@ 
[萌神奥莉][萌神奥莉] @胡議尹@:DAY3高贵冷艳型???? @章元一@:戛纳第三天 白天鹅～ ❤❤❤ @卜柯文@:DAY3 范冰冰 in Ralph&amp;Russo 2015SS	Day3  @萧邦Chopard@ 全球品牌大使范冰冰，出席萧邦戛纳Trophée Chopard晚宴。 
你们喜欢就好啦！ @范冰冰工作室@:[愛你][愛你][愛你]	  W Magazine: 令人无法呼吸; People: 时尚风格大胆；Glamour: 今年戛纳最美的裙子之一；E!Online UK: 最新时尚偶像; Bustle：令人目光留驻，宛如仙女；Blouinartino：戛纳第二日最佳8个造型之一，居于山林水泽的罗神; 戛纳电影节官推转发：范冰冰是关注戛纳红毯的理由 
唯情不变！@范冰冰工作室@:千年流转，________！	新海报曝光咯~盛唐时代的皇室绝美爱情你感受到了吗~千年流转，唯情不变@范冰冰@ @黎明@ @吴尊决定勇敢@ 
大拍有范儿！以后自拍就靠你了！军哥，我摆的手势可还标准？	揭秘来喽！欢迎@范冰冰@ 成为我们的代言人，大拍有范儿妥妥的。why这个手势？VIBE Shot大拍有物理按键，所以横过来拍照和自拍更合适。赶快跟我们一起做这个有范儿的快门手势，再不摆，你就out了！ 
元庆大哥，叫我小范、冰冰、小胖都可以！小伙伴们觉得哪个好？	@范冰冰@ 今天成为联想产品的代言人。有人叫她范爷，有人叫她女神，大家觉得我该叫她什么好呢？ 
台北小聚 薇快来	我們@赵薇@ 約嗎 
我们	我们 
此处应有转发！	“流言止于智者”是一种奢望，毕竟智者不常有，这纸我们尽管不愿作但又不得不作的声明，是为传达不畏流言之坦然，还以真相之信念。让一切不快就此完结。感谢一直信任和支持范冰冰的朋友，你们的鼓励是她一直努力奋斗的动力。 
小磊哥，双肩背那张好青春呀！戛纳晨跑？	再见戛纳，机场偶遇@范冰冰@ ，女神还是那么迷人！ 
凡 说好的鬼脸呢[拍照][给劲]	看完复仇者联盟，来看我们全新的挑！战！者！联！盟！呵呵哒！[杰克逊]鬼脸VS正常，爱哪款？[瞧瞧]@李晨@ @林更新@ 今天你们没来也没什么，合影有人帮你们站位。。请自行脑补 
煎饼侠变身前，回来啦！	《屌丝男士4》第1集视频：<  回来啦！ 
歪果仁真的很热情！可爱！ @范冰冰工作室@:“bingbing,我爱你！！”歪国的朋友，你们的中文说得真棒！[强] 祝所有朋友520快乐，小伙伴们赶紧去表白吧！	【视频】Fan Bing Bing at Chopard Party in Cannes  < 
感动，致敬！	 【他们真的太累了！】这是连续奋战66个小时，抢通陆上救援大通道后的武警水电官兵。@军报记者@ 
最好的消息！@陈砺志@:迄今为止，过去成功手术超过200例，无一例手术失败。在历年的复查中，孩子们均健康成长，无任何手术后遗症。特别感谢@上海远大心胸医院@ @清华大学第一附属医院@ 六次进藏的医疗组，手术主刀大夫和医护人员。	十个经过@上海远大心胸医院@ 和@北京清华大学第一附属医院@ 已经成功手术治愈的孩子们前来复查，其中还有两个第一批手术的小帅哥，经过医生的再次检查，这些孩子恢复状况都特别棒，我们也为他们准备了文具礼物，愿他们快快乐乐的成长，开开心心学习 
小四，你打戏用替身吗？不用的话我下手轻点	  有人能猜出我演什么角色。 
今天我们前方的同事将去到日土县多玛乡，热帮乡，给这里的小学生及周边各村孩子做检查。日土周边乡村海拔平均在5200米左右，先心病的发病率也偏高。听说那里气候严寒，今天下雪了，大家辛苦！	6月3日·第三站，驱车228里，来到海拔4400多米的日土县多玛乡小学，为这里的孩子筛查 
感谢我的朋友们，我们的医生、志愿者、阿里红会的同事们，爱里的心，因为你们每个人而更美好！	 普兰县筛查，钧甯将捐赠六岁的旦增曲英，曲英是后天形成的漏斗胸，钧甯将承担孩子去上海的手术费外加母女往返差旅。李晨捐赠一台便携式手持B超检测仪。感谢！@上海远大心胸医院@ @清华大学附属第一医院@ 三位主任今天辛苦了！ < 
顺利完成今天的工作！海拔4700，同事们不同程度的出现高反，但大家都在坚持，感谢！最好的儿童节！	拉萨飞阿里，在机场团队大面积吸氧；驱车220公里，路过神山，在塔尔钦简单午饭，打针的输液的吸氧的，全都感受到海拔直升1000米（4700米）的威力；别问我冰冰李晨张钧甯谁有高原反应，因为他们的表现都超出了预期！还有100公里，我们到达普兰，今天的筛查和回访工作等着我们???? 
说好的结伴同行！世界屋脊的屋脊，我们来啦！	因為愛妳的心，讓我認識，真好！@范冰冰@  
六年，重回阿里！❤@范冰冰工作室@:2010到2015，六年，成功治愈孩子200人，我们一直在继续。感谢所有给予过帮助的朋友们❤今年@范冰冰@ 再赴阿里，同时也欢迎@李晨@ @张钧甯@ 加入我们入藏的队伍！	 2010年8月，爱里的心第一次到阿里筛查，范冰冰也亲自前往，更经历山洪暴发，范爷临危不惧赞赞哒[好棒]时隔五年，今年范冰冰再次走在阿里爱的路上，一路相伴 ，为爱付出，愿接下来的筛查工作一切顺利 <  <
没要你的全部，只是头！别怕别怕！	谁要把我交给国家？这是什么梗？ 
缓歌慢舞凝丝竹。@范冰冰工作室@:低眉信手续续弹	昨日花絮。 
孩子的健康和笑容是我们坚持的动力，参与的每一个伙伴，你们都是最棒的！	六年坚持，我们依然在路上 
“这一次，希望有更多人听见流星的声音，哪怕只有一秒。”	<★★★★★，说好的伟仔影评，来了！小浪用颤抖的双手奉上！华语影坛最大咖影评人出山，首秀献给！@爾冬陞@ 宝哥请验收！听见流星的声音——这标题！这浪漫！这颜！这演技！还有这文笔！男神果然都是开挂的！  
给嗯哼的新鞋买好啦过来给干妈亲一口@霍思燕@:更正一下：大叔@陈赫@ 二叔@郑恺@ 美丽的干妈@范冰冰@ 嗯哼大王的球鞋小啦	今晚20:20，浙江卫视，看跑男乱入爸爸回来了！看 星光熠熠强大亲友团！干爹@李晨@，舅舅@郑恺@、@陈赫@！ 
甜蜜的梦想！明天高考的同学们一切顺利！加油！@景甜@:见到孩子们的笑脸，想起自己的童年见到建好的图书馆，好得出乎意料，非常开心 @陈砺志@:谢谢景甜同学捐建的24个图书馆，后续建设正在紧锣密鼓进行中。	项目刚刚结束，麦特公益又出发了，今天我们抵达湖北利川，参与捐建的蒲公英儿童图书馆开馆仪式，这次建设的是景甜捐建的第7个和第8个馆，也是整个蒲公英项目的第96、97个馆。美丽的利川都亭一小和一小分校的小朋友们，我们来了，新馆即将开启哟～ 
此次检查超1800个孩子，确诊需手术16例，我们会尽快安排他们前往北京、上海医院接受手术。感谢会长，老陈，格桑，以及“爱里的心”所有同事愿孩子们更好！	感谢阿里地区红十字会的同事们，感谢所有队员和志愿者们，感谢@上海远大心胸医院@ @小儿心脏病李小波医生@  张主任和@清华大学第一附属医院@ 唐医师，也谢谢@张钧甯@ @李晨@ 的加入和捐助。感谢大家一路上虽然头痛吸氧、恶心呕吐、发烧打针，却依然坚持@范冰冰@ @陈砺志@ @麦特文化公益部@ < 
转需！准大学生朋友们，高科技来帮助你们选择喜欢的学府，机会就一次，千万别错过！祝各位学子金榜题名，加油！#报志愿，防撞车#	考分重要，志愿填报得当同样重要！每年都有大量考生由于信息不对称造成志愿撞车而落榜，一分只差可能就错过理想的大学。手机百度相信技术的力量可以帮助考生把12年拼搏的每一分发挥到极致，基于大数据和智能算法研发出高考志愿填报助手，#报志愿，防撞车#让每一分都有意义，手机百度搜索即可体验 
好听！	我爱这个音区的声音，然而与@Karen莫文蔚@ 的合唱，好像又推开了一扇门，遇见了动人的风景。谢谢你。 推开门，“听”风景。[最右]< 
相见恨晚！@陈柏霖@ @張鈞甯@:永生難忘！@范冰冰@  @何润东@:喷泪必须 @張鈞甯@	6/19上映的喜歡的朋友來分享觀後感吧！還未體驗的朋友，你期待嗎？@何润东@ 你先來說說吧！ 
朝着梦想出发！加油！	2015环塔拉力赛～开～始～啦～ 
就酱给大家看我摔的这蠢，右边今晚真的不用跪榴莲？	女神一样的女友走的好好的突然就跪下来了，吓死牛了…只能补上一句：这头发甩的，你值得拥有。 
这套片子的主题:我还没睡醒！	范冰冰为《红秀GRAZIA》杂志@红秀GRAZIA@ 拍摄的第207期封面大片终于来了！窗前镜中的一杯牛奶，一本好书，开始了全新的一天，这样的冰冰，一定是你没见过的！感谢老朋友漫姐@陈漫ChenMan@ 掌镜！ 
龙式喜剧 爆笑圣诞夜	由成龙，范冰冰，约翰尼·诺克斯维尔主演，好莱坞导演RennyHarlin执导的《绝地逃亡》曝光一组剧照和先导预告片。片中不仅有激烈的打斗，惊艳的美人，其搞笑的剧情也是一大看点。影片讲述成龙饰演的警探被陷害后与一赌博高手跨境逃亡的故事，范冰冰饰演成龙侄女。电影12月24日上映。< 
必须有范儿！	@范冰冰@，小范，有范儿吗？看这里 < @联想@ 
新玩法！	 微博CEO@王高飞@ 先生邀请张宏森局长成为微博点评团的一员，还透露在未来，微博和新浪娱乐将与电影、明星展开更多新玩儿法。微博电影高级策划经理汤云波介绍微博今年的新玩法、新尝试；新浪娱乐事业部商业运营总监@吴赫@ 正式宣布明星线上经纪战略。期待和您一起 “娱”生万物 “数”定乾坤！ 
努力！路人甲！	< ★★★★★， 一起来围观东方教主大作！@林青霞@ 回首当年，忆与@爾冬陞@ 片场旧事，更以前辈身份鼓励新人努力追梦。其文娓娓，其情拳拳。这行云流水的巨星风范，果真是文如其人< 
好的	《烈日灼心》  2015年8月27日   正式上映  是朋友帮转发 
期待@陆川@:转发微博	  @陆川@ 执导的电影《鬼吹灯》首版预告震撼来袭，@HERO趙又廷@ @姚晨@ @冯瓅胖胖@ 吹灯三人组首度集结，@凤小岳@ @唐嫣@ @李光洁@ ‘探险者联盟’探访秘境，@李晨@ 神秘人初现真容。未知的生物，古老的文明，国庆档铤而走险，你做好准备了么？< 
因薇爱，让更多白血病孩子重获健康，V爱在行动！	感谢亲爱的小胖同学@范冰冰@ 的捐品雕塑：《Because of Love》，由雕塑家向京创作并亲自创意着色绘制，只此一件。希望@V爱白血病专项基金@ 资助的孩子在未来可以拥有微笑、阳光、美好的一切。大家有没有发现这件拍品原本应该叫《我们》……谢谢@刘亮游久@ 先生以9万元的价格竞拍成功。 
唔该晒！@范冰冰工作室@:香港嘅朋友，多谢你哋对武媚娘嘅爱！（用不太标准的粤语表达对你们的爱）	 【《武媚娘传奇》延续收视神话 TVB破30点创新高】由范冰冰、张丰毅、李治廷等领衔主演的年度古装巨制《武媚娘传奇》在香港开播以来，口碑及收视不断上升。星期日晚播出的第55集，平均收视29点，最高30点；而第56集平均收视29点，最高31点接近200万观众捧场，刷新了自身最高收视纪录 
what are you 弄啥嘞？@陈赫@ @李晨@	明天周五了，晨赫党们的福利来啦 
今天去电影院看????什么片？大家都知道了吧！	横版预告&gt;&gt;喜剧版预告&gt;&gt;< 动作版预告&gt;&gt;< 国际版预告&gt;&gt;< 终极预告&gt;&gt;< 看过这么多物料，还是看一场电影过瘾。“今天”6.26上映，去看吧。 
好久不见，和大双眼皮一家人再见面还是那么亲魔先生完全就是靓靓姐的翻版太靓仔啦！	張先生????????帶魔先生????????去見武則天????????，魔先生超開心????????！謝謝冰冰@范冰冰@ ！謝謝京花姐！ 
百人援贵，即将出发！五年坚持，点亮爱心。韩红姐，加油！	抱歉，此微博已被作者删除。查看帮助：http:t.cn/Rfd3rQV
学冬原来是专业歌手，真好听！	“有些人，交错后就转身。有些人，还留在原地等。”想起你，曾经岁月年华中出现的每一个你。谢谢你，曾经平凡生命中出现的每一个你。你给我的每一份力量，让我学会成长。灯光点亮，最终散场。请再等一分钟，请再陪我一程。请你聆听< 
终于等到你！一直美美的幸福下去！@张靓颖@:陪伴我从120到90……	岁月有着不动声色的力量。。陪伴才是最长情的告白！Love You???????????? 
兄弟们奔跑吧！期待你们7只的下一季！还想再去和你们玩儿！摩拳擦掌????????@李晨@:一路奔跑，感谢有你。今晚最后一期，一起快乐吧。	一路奔跑，感谢有你。短短三个月，兄弟团@邓超@ @李晨@ @陈赫@ @angelababy@ @郑恺@ @王祖蓝@ @包贝尔@ 给我们带来了最纯真的快乐。第二季最后一期，今晚21：10奔跑不息欢乐不止。< 
一袭被裁剪的衣服，一位爱恨成痴的佳人。所有人的心血，都只为了她，杨玉环。	@范冰冰@ 琵琶语海报幕后解密曝光。殿堂级设计大师和田惠美化衣于心，素雅而不失华丽。金牌导演组十庆、田壮壮、张艺谋指点江山，绝色贵妃跃然纸上。7月30日全国上映，美境佳人待君赏。@布法罗的树孙郡@ @范冰冰工作室@ < 
女人需要变得更优秀，因为这也是我们爱自己的一种方式！祝巍姐新书大麦！	做《时尚cosmo 》主编14年第一本书。我们择业时，他们说女孩子工作差不多得了； 我们选择男人时，他们说太优秀的女人没人要；我们不满现状时，他们说知足吧有这个男人（单位） 要你不错了。真心痛恨这些限制女人发展的鸡汤，心里硫酸才是真励志，泼一回！ <  < 
我们每个人在不断地与红尘世界发生矛盾和冲突，也许我们都是或者曾经是《道士下山》中的何安下，吃尽了生活的苦，拼命地寻找一条活路，最终懂得了，人活着，内心的天大地大已经远远胜过了眼前的果腹之食。	对你说。 
一切顺利@范冰冰工作室@:希望小朋友们都能早日康复，更希望接下来的孩子都能顺顺利利完成手术	手术进行时今天有两位小朋友分别进行了封堵和开胸手术，昨天进行漏斗胸手术的小朋友也将于今天复查胸片，孩子们状态还不错，加油@范冰冰工作室@ 
 一袭汉服演绎华夏千年文明，三千粉黛拱卫王朝绝世佳人。衣袂飘飘处，缤纷如莲开。	后宫佳丽三千人，三千宠爱在一身。美轮美奂的华服，倾国倾城的佳人，愿用千年等待换你朝夕相伴。@范冰冰@ @范冰冰工作室@   
谢谢老朋友Cosmo，总能带给我熟悉的快乐和新鲜的惊喜！	范冰冰与@时尚COSMO@ 四度携手周年刊，美妙的缘分和默契的情谊全部凝聚在了这组大片之中。22周年纪念大刊已上市，冰冰主演的电影《王朝的女人·杨贵妃》也将在7月30日跟大家见面！让我们一起将温暖、美丽和正能量传递给更多人！< 
一代萌宠诞生记有笑有泪、闹腾温情，暑假就要合家欢啦！胡巴胡巴	 妖界小萌主即将降临人间， 今晚零点开启全国公映！见证胡巴萌翻人间～！< 
但愿常相知，莫负知心人。7月30影院见@吴尊决定勇敢@:男孩到男人，的确需要很大的勇气... 難免会犯错，但要知错能改... 希望寿王可以带来一些正能量给到大家???? 7月30見????	少时寿王，意气风发，冠玉“蓝颜”，佳人在侧，奈何少年总无情……“吴尊特辑”解密幕后花絮，@吴尊决定勇敢@ 完美演绎@黎明@ 第十八子寿王，又缘何掌掴爱人@范冰冰@ ？《王朝的女人·杨贵妃》7月30日全国上映，一起见证王子吴尊的成长！< 
7月17票已买！我会准时粗线在电影院围观大侠哒！	《煎饼侠》终极预告片：< 7月17日，拯救不开心！ 
栀子花开，so  beautiful  so  white 有的是你，有的是我。晚上准备去电影院看一场，来场偶遇？	点映后看到一个很喜欢的简单影评，说他在《栀子花开》中找到了自己和朋友的影子。其实，这就是一个会发生在你身边的青春故事，有的角色是你，有的是我，也有的是你心中的另一个自己，那个自己，不被时间改变，很可爱。愿你，找到另一个自己。<  <  <
哇！地球终于有了男朋友！	【NASA宣布发现#另一个“地球”#】美国航空航天局（NASA）宣布发现了新的外行星Kepler-452b，为地球直径的1.6倍，位于距地球1400光年的天鹅座。Kepler 452b上的一年大约385天，其围绕运行的是一颗与太阳相似的恒星，使得Kepler 452b成为到目前为止最接近“另一个地球”的系外行星。@微天下@ 
昨晚北京大雨瓢泼，朋友们依然赶来支持我们的首映！玉环在此谢过大家了！	昨天，冰冰身着Ralph &amp; Russo白色高定礼服，佩戴@萧邦Chopard@ 珠宝出席《王朝的女人：杨贵妃》全球红毯。一袭纯白的古典气质，梦回唐朝的历史重温，7月30日，我们和贵妃不见不散。 
今天贵妃首映！六年，终于等到你！	 《王朝的女人•杨贵妃》明日将举行首映发布会/首映礼，历时六年，首露真容~届时，导演十庆、主演@范冰冰@ @黎明@ @吴尊决定勇敢@ @吴刚de微博@  @金浩Hys@ 等将华丽亮相，与大家共同见证历经六年打造的传奇爱情巨制迎来千年瞩目一刻。六年远征，明日回朝~ 
生日快乐！愿你的小宇宙更加光亮	又是生日,今年有些特别感触.出演《长城》,跟着张导学习表演有了全新体验,一部电影跨越三度寒暑,艰难曲折尽在心中;成立甜蜜梦想基金,投身蒲公英儿童图书馆项目,从孩子们阅读的笑脸中体会到别样快乐;还有质疑、嘲笑、批评,是我成长的荆棘.嗯,又一年,我会加油,谢谢所有人,为甜妹子加油吧! 
天长地久有时尽，此恨绵绵无绝期。	在天愿作比翼鸟，在地愿为连理枝。 摄影：@布法罗的树孙郡@ 
玉环和寿王这厢有礼了！在此先跟大家露个脸，欲知后事如何，7月30号电影院分晓	 @范冰冰@ ＋吴尊：当霸道女总裁遇上害羞男神 会擦出什么样的火花？ 范冰冰：我决定去做的事，一定要全力做好 吴尊：我有很多梦想，但我不急，一步一步来 @范冰冰工作室@ @悦己女性网@ 
做男人的最后一个女人，才是真的幸福！	终极预告片和终极海报开启一代盛唐传世情缘。杨贵妃@范冰冰@ 与寿王@吴尊决定勇敢@ 缘何撕心断弦？又如何相遇唐明皇@黎明@ 情用命赌，互许终生?7月30日全国上映, 约你感受生死盟誓下的别样扣人心弦。< 
若非死别，绝不生离。7月30日，随玉环入梦。	终极预告片和终极海报开启一代盛唐传世情缘。杨贵妃@范冰冰@ 与寿王@吴尊决定勇敢@ 缘何撕心断弦？又如何相遇唐明皇@黎明@ 情用命赌，互许终生?7月30日全国上映, 约你感受生死盟誓下的别样扣人心弦。< 
挑战结束一起嗨！祝贺大鹏！继续前进！	挑战者联盟一起庆祝破3亿！ 
7月30号，就要来咯@范冰冰工作室@:730越来越近了，贵妃陪你过暑假 @电影王朝的女人杨贵妃@: 这个暑期有贵妃相陪。还在等什么，火速抢票，影院约起~@范冰冰@ @黎明@ @吴尊决定勇敢@ @吴刚de微博@ @陈冲@ @宁静@ @范冰冰工作室@	由@范冰冰@ @黎明@ @吴尊决定勇敢@ @陈冲@ @宁静@ 等主演的电影《王朝的女人·杨贵妃》提前预售，每张只要18.8元，走过路过不要错过哦~~抢票戳→_→< 约起！ 
Neinei宝贝好可爱！小贵妃说了，现在已经7月30号了！我们不见不散！	Neinei說：大家好！我是楊貴妃！7月30號！見！GOOD！～@范冰冰@ 妳覺得這個小頑皮有潛力當貴妃嗎????@电影王朝的女人杨贵妃@  < . 
明日上映，请多关照	冰冰身着Alberta Ferretti 2016春夏Limited Edition系列 金箔蕾丝礼服裙，佩戴Chopard璀璨珠宝出席<广州发布会，三位主创在台上畅聊杨贵妃背后有趣的小故事 
你们好配！@高圆圆@	@范冰冰@ 
明皇与玉环，只此一生，只此一世。730与你相约。@黎明@:君临天下，唯情可殇。我和小范的努力，730与你相约。	 黎明特辑揭秘“史上最文青”帝妃夫妇日常。唐明皇@黎明@ 一半是霸道总裁不怒自威的火焰，一半是与贵妃@范冰冰@ 扣人心弦深情似海。7月30日，杨贵妃唐明皇款款专情，一起见证！< 
你打算把我挤到哪儿去？[抠鼻屎]	我认为我的修图水平已经出神入化了！ 
如果让我用一句话概括我对杨贵妃的感受，那就是“我想成为她，我庆幸不是她”。	 冰冰带着《杨贵妃》来到上海，走了7家影院，做了很多采访，谢谢影迷朋友们的热情，缓解了冰冰连续工作的疲惫。希望冰冰和贵妃的相遇，能让大家感受到那段盛唐的凄美爱情。服装：Ulyana Sergeenko Demi-Couture系列印花连身裙，珠宝：@萧邦Chopard@ 
我们的小朋友在上海的治疗都很顺利，很快就可以回家了！真好！	今年在上海治疗的第17批孩子，心脏病手术都很顺利也很成功，在孩子们离开上海回阿里高原之前，小胖@范冰冰@ 在紧张宣传电影的间隙抽空看望了他们，大家很开心。回去后从此健康，快乐成长吧！ 
看尽世间之爱，懂得人间之情！手机和平板电脑想要哪个？想好私信我吧！	《爱》霓裳未完，情永留；一曲悲歌，散人间——《王朝的女人·杨贵妃》影评@范冰冰工作室@：霓裳未完，情永留；一曲悲歌，散人间。——题记            知道电影《王朝的女人·杨贵...文字版&gt;&gt; < （新浪长微博&gt;&gt; <） 
第一个奖我来开！平板电脑送上！ 大家一起玩起来，让我看到你们的小手手	刚刚看完。情意绵绵，是最合适的词了。曾经无爱无情，终究化为同生共死的誓言，缠绵悱恻间灰飞烟灭。完事终了，而我心里还是满满的爱。可以想见皇上的以后，是痛苦，愧疚，无望而怀旧的，或许会坐在长城脚下，等待它的千年后废墟，看看美不美，毕竟皇上是万岁的圣上。@范冰冰@ 爱这部电影 
 ，那么问题来了：爸爸去哪儿	发现好多小伙伴都了，谢谢大伙对我们电影的支持。明天就是周末啦！你打算约谁去看《杨贵妃》呢？ 
贵妃谢谢各位盟友的支持咱们穿成这样，不去制霸湘北真是太可惜了@陈汉典@:挑戰者一起祝貴妃紅紅紅 @林更新@:鹏，你没凡凡帅。  祝票房大卖 @大鹏董成鹏@:我好帅啊！借大红的衣服祝贵妃票房红红火火！	挑战者联盟的盟友给贵妃加油。@Mr_凡先生@ @林更新@ @大鹏董成鹏@ @陈汉典@ @范冰冰@ 
Vogue十周年????@赵薇@: @angelica张宇@:难得、难忘、前所未有的历史时刻。	 9月号纪念刊封面来了！前所未有聚齐十位一线女星拍摄封面及内页大片，在@Mario_Testino@ 镜头前演绎黄金年代的女神风范，庆祝《Vogue服饰与美容》走过的金色十年，赞美那些最具代表性的中国女性。纪念刊特别推出金色、银色两个封面珍藏版，将于8月10日正式面市。 
福利到！十部手机，十台平板电脑，大家不要客气哦参与方式戳下图！	 贵妃福利大放送！十部联想手机、十台联想平板电脑等你来拿~详情请戳长微博 <  
贵妃上映第一天，听说成绩不错哦????????所以我要大放福利咯，谁看过啦？晒票根，让我看到你们的小手手	冰冰昨日身着Ulyana Sergeenko 2015秋冬高级定制系列冰蓝色刺绣丝缎长裙，佩戴萧邦璀璨珠宝亮相古都西安。7月30贵妃到来，忆起唐朝旧梦不改，今天大家记得去看《杨贵妃》哦！   @萧邦Chopard@ 
情侣观影须知→→@范冰冰工作室@:如果你的女朋友在观影过程中哭了，请不要吝惜你的面巾纸和袖子，帮她擦干眼泪，或者陪她一起哭！	《王朝的女人杨贵妃》今天已经公映啦！看看今天网友们的评论说都，若非死别，绝不生离，今晚走进影院吧。 
@苏芒@: 你是我的铠甲，你是我的软肋！！！9月刊封面来啦……	国民情侣虐哭单身狗节奏走起！@范冰冰@ @李晨@ 超亲密首次独家登上《时尚芭莎》9月上封面！芭姐贴身直击“晨冰恋”甜蜜现场，零距离揭秘“小范儿”与“大黑牛”私密时刻！ 摄影@陈漫ChenMan@ @苏芒@ @小荔BAZAAR@ 总策划@左敏洁KT@ 造型@卫甜BAZAAR@ 购买链接：< 
只此一生爱，只此一世缘！	&quot;情用命赌&quot;是世间最动人承诺，即使跨越千年依然历久弥新，潸然泪下。@电影王朝的女人杨贵妃@ 让我们在炎炎烈日体验了盛唐繁华精美的历史，欣赏到了一部唐代视觉盛宴。六年磨一剑，倾心铸芳华。过程虽波折，佳片献观众感谢你们@范冰冰@ @范冰冰工作室@ @黎明@ @吴尊决定勇敢@ 
未来能够拥有无数个幸福的9年，祝福你们一路到白头！	我愿与君若非死别，绝不生离。这些票根记录了我们九年的婚姻，谢谢不看爱情片的老公愿意陪我一起看。也谢谢大姑子帮我们带2妞儿，让我们过2人世界@范冰冰工作室@ 
叹息无奈世事万千，物转星移盼传唱佳话！写得真棒！今天的手机就送给你啦	叹息无奈以后又看世事万千，观物转星移之时又传唱佳话。 这段爱情很感人，谢谢你们的诠释@范冰冰@ @范冰冰@ @范冰冰工作室@ @黎明@ @吴尊@ 
来自彩云之南美丽的姑娘，谢谢对《杨贵妃》的喜爱，平板电脑送你，愿你开心每一天！	来自西双版纳一个夜晚摆地摊的小主儿，下雨才能去看电影。而杨贵妃必然是奔小范儿去的，之前影评木有关注我只关注我看到的电影是否让我触动和值得，确实也没让我失望，雨夜一个人去看这部电影，虽然知道历史结局是啥样，但过程的温暖之爱之语之情，也温暖整个雨夜回家的路。@范冰冰工作室@ 
转发微博	杨贵妃@范冰冰@ 特辑奉上！与唐明皇@黎明@ 史上最文艺灵魂伴侣为唯美再现贵妃之情，“贵妃醉酒”片场大胆喝醉。听范冰冰倾吐贵妃梦，祝“每个女孩都可以有一个像唐明皇这样的男人，这么足够的去爱你们”。亦或拥有一个像@吴尊决定勇敢@ 那样的大唐蓝颜 < 
Vogue十周年  生日快乐！☀	 @范冰冰@ 见过了最好与最坏的事。十年，她做了很多别人做不到的事情，创造了一些坚毅或柔软的角色，引领着美的风潮。《X战警：逆转未来》的导演Bryan Singer盛赞：“她有着令旁人‘黯然失色’的魅力，却还依旧为每个新的任务奔跑。” < 
谢谢成都热情的朋友们，可惜时间赶，没吃上火锅  一定得找机会补上	范冰冰身着Proenza Schouler 2016早春度假系列白色印花连身裙，佩戴@萧邦Chopard@ 闪亮珠宝来到蓉城，参与<发布会，更与观众们在影院里零距离聊天 
当然好！谢谢关注这部电影的朋友们！@范冰冰工作室@:贵妃娘娘，发微博加话题“晒票根+写影评”赢手机电脑活动正在火爆进行中！这位朋友@盼暮@ 写的走心了！准备送上手机一部，好吗？	抱歉，由于作者设置，你暂时没有这条微博的查看权限哦。查看帮助：网页链接
少年梦 他唱的@李晨@:开播倒计时2天，秀才遇到兵。	【曝李晨主唱MV】继沙溢之后，鲜少展现歌喉的大黑牛@李晨@ 也为戏发声，演唱片头曲《少年梦》。曲风朗朗上口，柔情满满，讲述剧中书生、痞子、花旦、侠女他们不平凡英雄梦，而作为剧中的学霸担当，秀才晨在历经山河破碎，生死别离后，弃笔从戎，成长为大英雄！[推荐]< 
献血信息	献血车一般是早上9点到达位置。填表后量血压正常就可以献血了。一般需要注意的是有没有近期服用过药物，女性有没有在经期，近期有没有剧烈运动，以及是否有传染病。要献血的同志们都请早点睡，因为休息不当会导致转氨酶不过关无法献血。献血时记得带身份证。 
@姚晨@: @老沉@:@今晚报@: @神经是病治不好@： 二街的华卫门诊和四街的泰丰社区卫生服务站马上免费开诊，伤情不是很严重的朋友可以去这里就诊！	@我是夜空中的月亮@： 大家注意！！！爆炸中，烧伤和外伤的，别往五中心挤，直接到东江医院来！烧伤科已准备好抢救！请相互转告！ 
????扩！@南方人物周刊@:有消息确认是天津开发区瑞海危险品仓库发生爆炸，喷发火球，引发开发区几个企业二次爆炸！建议附近的网友关好门窗，不确定是否有有害气体，减少外出，不要凑热闹。附近几家医院都已陆续满员，预计会出现血液储备不足的情况，呼吁有条件的网友做好去附近血站献血的准备。	【塘沽发生爆炸事件，现场升起蘑菇云】据网友爆料，天津滨海新区开发区发生剧烈爆炸，现场升起蘑菇云。数十公里外有震感！网友称，爆炸导致附近楼体晃动甚至裂缝，据悉开发区也有强烈震感。视频1：< 视频2：< 
哎哟，不错哟！	冰冰我已經盡力了@范冰冰@ @李晨@ 
支持杰哥！@张杰@:对于始作俑者，绝不姑息！	我们一直以来都无视各种负能量，专注传播积极正面的能量，但今天也不得不站出来坚决抵制捏造和散布虚假信息的行为。谢谢大家一直以来的关心和爱，谢谢大家的支持！ 
以浪漫之名，赴真情之约@吴尊决定勇敢@:把最美的电影和最真诚的感动带给懂得欣赏的你。@电影王朝的女人杨贵妃@: http:t.cn/8k6GGpt 我带着你，你带着卡，来一场说看就看的电影~7.30@范冰冰@ @黎明@ @吴尊决定勇敢@ @吴刚de微博@ @陈冲@ @宁静@ 与你在影院准时相约，带给你清凉一夏	抱歉，此微博已被作者删除。查看帮助：http:t.cn/Rfd3rQV
你依然是中国的骄傲！早日康复，明年再战里约！	今天对不起大家，因为心脏不适决赛退赛，没能为中国再多赢得一枚奖牌，我真的拼尽全力了，很高兴能第二次蝉联世锦赛MVP，中国游泳队也百花齐开，圆满收官，我知道我身上是国旗的重量，承载着大家的期待，请大家相信我和中国游泳队，失去的我们一定会拼回来！明年里约见分晓！ < 
跑起来！越挑战越有范儿，今天的摇滚跑太好玩啦	我们的关系就是这么复杂。乐疯跑，见好友，陪想粉。我是来炫心情的。@范冰冰@ @潘石屹@  @张欣@ @苏芒@ @周十八公@ @童夫尧@ 
你好，Shirley杨[甜馨得瑟]	胡八一，好久不见，我是shirley。???? @电影鬼吹灯之九层妖塔@ 
这是一段很动人的话语，因为坦诚，因为足够了解他的故事，人的一生很长，起沉浮落是常态，放的下，就不孤独。	【我为什么剃光头？励志】特喜欢他的齐天大圣孙悟空，还喜欢机灵小不懂，还喜欢方世玉。还有记得的朋友么张卫健演讲：我为什么剃光头。励志by网络 < 
这集得看！	今晚，龙千言在忠孝两难中苦苦挣扎，战场上以枪指父。我也做了回最悲情男主。 
此刻，无论你在哪，一起为遇难者默哀。	【头七之祭：天津举行悼念活动】上午9时，天津滨海新区举行悼念活动，分别在6个不同地点举行。在天津港六号门前的抢险救援公安消防前方指挥部，国务委员、公安部部长郭声琨率国务院工作组、参加救援的消防官兵向事故遇难者默哀。此刻，无论你在哪，一起为遇难者默哀。（朱少军） 
活着，就是希望！逝者安息，生者顽强。向救援战士们致敬！	【活着真好，爆炸亲历者讲述那一夜】那一晚他们经历了什么？天津爆炸的亲历者们讲述生死瞬间：< 
为救援车辆让出生命通道！@人民日报@:【转发提醒！在这8家医院附近，别乱停车】据@天津交警@ 驾驶员注意，这8家医院为：塘沽泰达医院、港口医院、第五中心医院；和平区总医院、眼科医院；河东区第三中心医院；南开区一中心医院；津南区海河医院。为救援车辆让出生命通道！转起！	【呼吁：请让出救援通道，避让救护车】不自行前往事故现场，避开事故周边医院路段，遇救护车请避让，让出生命通道；献血：天津血液中心022-27611233；滨海新区中心血站022-25788005，献血不空腹，不饮酒，不吃油腻物品；津滨轻轨9号线停止运营；进出天津港，请绕行五号门、八号门。天津平安，转起！ 
有!  怪!  兽!   吓死宝宝了!就等十一去看啦!	  怀胎二十月，朝夕相伴；一根骨头一根骨头，抚育成精，今日送别。挥手自兹去，孤蓬万里征。一定按时刷牙 @姚晨@ @唐嫣@ @冯粒胖胖@ @HERO趙又廷@ @李晨@ @李光洁@ @凤小岳@ @王德顺@ @吴军@ @王庆祥@   < 
???? @范冰冰工作室@:初秋的一抹粉红，拍摄于今. 年戛纳	抱歉，此微博已被作者删除。查看帮助：http:t.cn/Rfd3rQV
和BAZAAR明星慈善夜一起走过了很多年头，每一次的感动都太多太多。今年，大家一起再努力！	 13年慈善长跑，2.6亿善款募集，19家慈善机构联动，爱在一个又一个与生命赛跑的故事中传递。今天，和@范冰冰@ 一起为生命加油，#慈善无憾，为你而战# ！请与我们一起，助力中国贫困县救护车救援，助捐链接< 
终于可以在大银幕上看这个故事，小齐哥做所有事都很用心，这次又有很棒的演员和团队，祝任导演的新作票房大麦！	今天就要上映和大家見面了！即期待又忐忑！想起籌拍到完成的時光，好多感動湧上心頭，謝謝所有參與的兄弟姐妹們！我相信我們交出了一部誠懇用心的電影！就期待您來肯定！ 
向敬爱的老兵 致敬！[玫瑰][玫瑰][玫瑰]	【致敬！老兵！】参加阅兵的抗战老兵，包括八路军、新四军、东北抗联、华南游击队和当年国民党军队等方面具有代表性的抗战老兵，平均年龄90岁，最年长的102岁。70年前，他们为民族而战、为祖国而战、为尊严而战。致敬！ 
今天去看！	公！映！了！由曹保平执导，@邓超@ @段奕宏@ @郭涛@ @王珞丹@ 主演的终于公映！华语类型片口碑之作，三黄蛋影帝共献高超演技，酷烈画风屏息凝神！点映以来收获好评不断，不一样的灼心之旅！不信，您来验验？ < 
听说电影很好看！我要去看！	由曹保平执导，@邓超@ @段奕宏@ @郭涛@ @王珞丹@ 主演的公映在即，连场点映好评不断！另有周迅迅哥儿捧场、邓超感性开嗓献声，为影片品质加持。夏日未完，余热灼心！8月27日，赴一场烈性之约！<  <
乖女儿！	三岁女孩知道糖被妈妈吃光后的惊人回答！太暖心了 < 
很棒的台北之夜！谢谢Vogue Taiwan CM总经理，及Vogue所有的同事们，期待下次再聚！	@范冰冰@ 今天出席VOGUEFNO台北時尚大秀，身穿FNO白色T-shir搭配Saint Laurent黑色青果领西装+Céline黑色阔腿裤+价值六千萬台幣 @萧邦chopard@ 珠宝 ，是不是很有型！！ @范冰冰工作室@ @范冰冰粉丝团@ FNO眾星紅毯直擊&gt;&gt;< FNO眾後台直擊&gt;&gt;< 
挑战者一起来！今晚第一期，等你！	开播倒计时最后1小时， 这一次，只为挑战！@范冰冰@ 联盟集结，为挑战而来！@巴黎欧莱雅@ 
哈哈，元庆大哥，北京机场是否已被联想全覆盖这就叫无可复制	下飞机，天气欠美心情好，廊桥见到联想范儿，充实的一天完美落幕，小胖@范冰冰@ 真漂亮[好棒] 
已戳！	王菲，“清风徐来，水波不兴”，好听！ 戳链接--&gt;< 
一个美美嗒另一个呢925看_____，两字,请填空。	美美嗒 
@李玉@:	恭喜电影 进军第20届  展映单元@李玉@ @方励@ @范冰冰@ @韩庚@ 。画林映像预祝@电影万物生长@ 釜山之行圆满顺利！ 
队友们来战吧！	 锁定明晚20:20浙江卫视,震撼播出！这一次，看 @范冰冰@ 潜力无边，一马当先！[拍手] 
这歌，有魔性	电影主题曲，颜值担当@黄渤@ 和萌叔@左小祖咒@ 的雅痞范儿《一剪梅》~ 层层风雨~不能阻隔~太魔性，这首歌有毒电影将于9月30日上映，9月27日点映，提前哈哈哈！ < 
芭莎慈善十三年的坚持，心系美好，感恩同行！@范冰冰工作室@:慈善需要坚持，爱心更需要坚持！希望这一份份温暖能够帮助到更多需要帮助的人	坚持比坚强更可贵，今夜我们一起为慈善助力！帮助贫困山区更多的人们，大家一同把爱传递下去！❤❤❤@李晨@ @范冰冰@ 
祝贺张帅????你赢了！我们都为你祝福！	 昨晚出席设计师张帅“时光之眼”世纪大秀组图 
今天遇到“劲敌”了，队友们准备好应战了吗？！	哪怕运动不是你的长项，也会勇于接受挑战。今晚浙江卫视20:35，看 直面挑战，变得更强！@巴黎欧莱雅@ 
《别有动机》今天上映！支持黄导！电影票已买好@黄岳泰影像@:真的不熟吗？那就试试吧@Pete三姑丈@ @刘伟强@ @i周迅@ @赵薇@ @黄晓明@ @范冰冰@ 希望大家多多支持	 视频曝光啦！[hold住] 、@Pete三姑丈@ 、@刘伟强@ ，@i周迅@ 、@赵薇@ 、@黄晓明@ …导演@黄岳泰影像@ 的朋友圈竟然有这么多大咖？真是让人眼花缭乱！所以宣传的事情就拜托给导演了！小伙伴们快戳链接来膜拜导演吧！[群体围观] < 
因为艰难，更要坚持。@陈砺志@:原本这次要来9个孩子，只来了4个是因筛查结束后，孩子们回到牧区，等到要来北京做手术，因牧区流动性以及广袤高原没有信号，有5个孩子的家庭联络不上，只能放到明年来做手术了。四年前在改则，有2个孩子没来体检，说放牧去了，坚决派车接来一查都是心脏病，已成功手术。	第18批患儿今日到达北京啦！这是2015年接受治疗的最后一批患儿。见到我们，稍显羞涩的孩子们手拉着手向我们微笑。在车上，孩子们一路新奇的看着窗外的风景。感受到孩子们的热情，我们也期待着他们的未来能够永远被健康陪伴！ 
靓颖，为你们的幸福而感动，终于等到了，一点都不晚，这是美好！	来，看看现场求婚视频吧！ < .  <
听说今晚有大变活人，剧透一下，那个活人就是我	今晚20:20浙江卫视，@范冰冰@ 告诉你：奇迹，只在弹指之间！ 
祝贺Jane！她人太好，真的是我的榜样！	好莱坞传奇女演员 奥斯卡影后简·芳达（Jane Fond）近日被本届圣芭芭拉国际电影节授予了柯克·道格拉斯终身成就奖。她接受中国记者采访时不仅谈到了对中国的印象，还向老朋友@范冰冰@  问好“替我向冰冰问好。范冰冰！我们一起合作过” < 
越是注重细节的呈现，越是凸显品质。	范冰冰 × adidas Orignals 2015秋冬广告拍摄花絮< 
我还可以教给你我的绝招徒手扔黑????！@姚晨@:我找机会把扔车这招教给你女友是真的…	哎呦嘿！大姚Shirley杨，女王力爆棚，找机会和正义的王馆长比比掰手腕咋样？ @姚晨@ 
爵迹好棒！@郭敬明@:我们宣传团队说，做营销这么多年，第一次被这种级别的数据体量吓到了。“爵迹微博热度狂翻322倍”????????????????你们感受一下。????????????????	【爵迹特刊】《爵迹》2.0通过@郭敬明@@新浪娱乐@@新浪电影@@电影爵迹2016@ 以及十一位主演的互动，主话题获得了6亿阅读量和334万讨论量。吴亦凡@Mr_凡先生@ 夺单人角色海报覆盖人次及女性最爱双榜首；@范冰冰@ 最受男性喜爱；@TFBOYS-王源@ 成人气担当→< 
让大家见识一下，什么叫动如疯兔	 现代冬季两项，由越野滑雪和射击两种竞赛项目结合在一起进行，要求运动员既要有由动转静的能力，又要有由静转动的能力。  今晚20:20锁定浙江卫视，看 @范冰冰@ 动静转换自如！[江南style] 
虽不近人情冷暖，但仍愿善待众生。亚斯蓝历史上第一个双身女爵来了！大家好，我是鬼山莲泉。	 天地众生，皆与你随行。你对命运的反抗，是你永生的勋章。五度使徒，鬼山莲泉。@范冰冰@  
蜜兔！想你时，你在闹海	想妳的時候，妳就在身邊！ 
 导演，这么炫酷治愈的密集恐惧症有些魔性啊	没想到@新浪娱乐@ 发布完概念海报后竟然出现了这种话题……SO！大方的我将全身版密集MAX补齐！密恐er们请接受治疗！有大神已猜透这装置背后的秘密...今天预热你们暖身好了吗？想看他们duang完后的造型吗？那就准备好迎接马上到来的真正xfxy的吧… 
我凡，我冬好帅！@郭敬明@: ????????????????指路第一波。我就帮你们到这儿了。我好困，继续去睡了。	小浪冒死抢来第一波物料，前卫视觉海报！来！了！第一次有物料不是从小四导演手里发出来，小浪觉得有点刺激……吴亦凡@Mr_凡先生@ @陈学冬@ 你们美你们先来。别问我这是什么造型、为啥先发这俩、密集恐惧症患者怎么办……有困难，找导演，实力甩锅30年！@郭敬明@  
小动物们放心，我很有经验的！改天我介绍大头给你们认识	 不打扰，是我的温柔。今晚20:20浙江卫视  带你！ 
真心没见过这么大坨的HOME键，可以指纹识别吗	我是HOME键，晚安！ 
该节目见证了右边变圆的全过程，请大家收看，奔跑吧????????????????????（认真脸	????????????????????????????今????????????????????????????????晚????????????????????????????????????????????????????????????????????????????????????九????????????????????????????????点????????????????????????????????????????????????????????????????????跑??????
国庆大哥悠扬的歌声之外，还有对中国传统文化的热爱，艺术是相通的，歌声和收藏都是生活中最值得分享的韵味与快乐。	千呼万唤始出来，新书终于出版了(此处有掌声)当当网已经开始预售了，前100本可是限量版亲笔签名的呦，还不赶紧行动起来，晚了可别后悔呦PS:为大家准备100本限量签名版正在进行时……亲笔签名版只有100本，只有100本，只有100本，重要的事情说三遍 
支持何爷新作！温暖人心的故事，诚意满满的作品，走进影院回到被爱的每一天，回到那些幸福的、感动的、笑着流泪的每一天	6年後電影作品「回到被愛的每一天」今天上畫，去電影院找回屬於你的愛，  希望大家支持！ 
每个人只能陪你走一段路。@路易威登@:@范冰冰@ 身背全新 City Steamer 手袋，该手袋将于10月30日在路易威登中国专卖店全面上市。	 2015年10月25日，@范冰冰@ 背@路易威登@ 新款City Steamer手袋亮相电影首映红毯，这款手袋中国将于本周五（即30日）全面上市。范爷是中国地区第一位手持City Steamer Bag手袋的女星哦。 
穿行中回到水草丰茂的家乡，在路上找回遗失的勇气和感动。乡愁与真心，足以值得你走进影院细细感受它。	《家在水草丰茂的地方》明天就要上映了，心愿总算靠近了现实：把这部可爱的西部公路文艺片送进观众视线，送一缕清风，一份清粥小菜。 十城试映跑完累得呲牙咧嘴，但那些掌声和令我泪奔的共鸣之音，给了我难忘的记忆和最大奖赏！ 期望它能给观众带去一次不同的观影感受，谢谢！< 
礼物到！@WXQkyxKGR@ @卡尔CareLee@ @冰邦俪-曦沐@ @被爱的小璇@ ，等着收视频祝福吧	最特别的礼物来啦！我将随机抽取4位转发本微博的朋友，送上我为你定制的独家视频祝福！大家赶快告诉我想让我录制的内容，说不定能成就几对有缘人！心意已备好，只等你的祝福！这个礼物大家可还满意？ 
队友们快来救我！我被节目组穿越啦！	 @范冰冰@ 北方有佳人，绝世而独立。 一顾倾人城，再顾倾人国。美人平生万种情思，悉堆眼角。今晚21:00浙江卫视，看 一笑倾城。 
好听！下次见到你，一定要当面唱给我听哦！凡凡生日快乐，一直阳光！????????????	担任制作人，作词又作曲，哈哈…真是够忙的在这个对我来说的特殊日子，把这份礼物《Bad Girl》送给大家，希望你们会喜欢哦。走你！听起！各位朋友们请不要客气的转起来吧< 
恭喜人之！提升颜值的必备宝典，赶紧入手一本来看看	就是喜欢美美的自己，不仅是我的态度，也是我的新书名[愉快]这本书筹备了那么久，终于要和大家见面了！来，一起变美吧！[爱心] 
HELP!逃亡路上等你来拯救，12月24诞求一笑！	 海报特辑双发，3国7地大逃亡，虐到深处自然萌。 大哥惊呼：“差一点死在广西”。@范冰冰@ 从六七楼摔下来究竟伤势如何？约翰尼·诺克斯维尔惨遭活埋真相哪般？@曾志偉獎門人@ 水下戏被冻惨是遭何人毒手？猛戳链接亮瞎眼< 
冬天冷，走走就暖和了@范冰冰工作室@:带着美丽和温暖漫步城际	 别被冬天的寒冷包裹住你出行的脚步，还不紧跟女神@范冰冰@ 一起出走。 
每双眼睛都是用来寻找光明的，加油幂幂	大多数时候我会觉得，谈自己的角色怎么演，是一件十分矫情的事儿，但关于盲女路小星这个角色，我心里确实有些话想跟大家分享，所以有了这篇《假如给我三天黑暗》，感谢每一个看了《我是证人》的观众，我的感受，与你分享 < 
机票不贵，你等着!	的士高动起来动次大次动次大次，让我们拍的更好，论拍照的角度与设备…发完这条微博后我就跑到澳洲先休息几天…不要找我！ 
很高兴与东风雷诺科雷嘉牵手，精致好玩的车模快来拿@范冰冰工作室@:牵手成功！感谢大家的祝福！	今天，东风雷诺正式宣布，范冰冰将成为其首款SUV科雷嘉的代言人！11月29日前，关注@雷诺中国@，转发此微博为冰冰和科雷嘉送上祝福，东风雷诺将随机抽取15名幸运粉丝，送出范冰冰亲手签名的限量版科雷嘉车模！@范冰冰@@范冰冰工作室@ 
广州见！@范冰冰工作室@:很开心即将跟雷诺牵手，11月20号快快来！	 11月20日，请见证我们的牵手！女王，在广州车展等你来！@范冰冰工作室@@范冰冰@ 
恭喜首次担任电影监制的小迅，支持《陪安东尼度过漫长岁月》！漫长岁月有爱相伴，把所有孤单都活成勇敢。简单、治愈、感人，大家多多去影院支持！	把电影里的歌和音乐整理出来给大家听????????????< 陪伴是最长情的告白????。 
 六年，因为有你们的帮助，我们一路前行。感谢李嘉诚先生、谢一铭女士、吴亦凡、张钧甯、李晨以及众多爱心人士的加入和善心，感谢上海远大心胸医院、清华大学第一附属医院的支持，让爱温暖每颗心	今天阿里儿童先心病项目收到谢一铭女士捐助200万元善款，代表阿里的患儿感谢您，六年来第二次接收外部捐款，第一次是李嘉诚先生捐赠200万（此外2014年吴亦凡资助5个孩子心脏手术）。今年是六周年，完成手术超过200例，总费用超过1200万，超出部分均为范冰冰承担。 
12308	【紧急扩散：出国旅游一定记住电话12308】法国发生恐怖袭击事件，中国驻法国使馆发紧急通知，提醒在法中国公民注意安全。中国驻法使馆领事保护与协助电话：0033-615742537。外交部全球领保与服务应急呼叫中心电话：00861012308。不管同胞身处哪国，拨通电话，就能得到帮助！转！ 
Madame Figaro新开始、新气象！期待和右边的各位，一起玩出更多精彩@闵塔鲨@:化妆@胡議尹@ 发型@化妆师高建@ 谢谢冰冰的信任 尝试了不同以往的妆容 即使当天已经工作一天 开拍之后的良好状态仍然无人可及 就是爱这样敬业的你@范冰冰@	范冰冰演绎Madame Figaro中国版创刊号封面大片，摄影：@陈漫ChenMan@ ，造型：@闵塔鲨@ ，化妆：胡议尹 ，发型：高建。明日起全国发售！ 
舍不得每一位挑盟的队友，舍不得每一位陪伴我们这么久的观众，最后一期，我对你们都“有一点动心”	 收官之战，我对你动心不止一点点，倒计1小时，看  
“不可思异”，不止一笑！提前剧透，片中出现高能萌物，它叫“么么哒”！欲知详情，买票去看吧！	【华语首部3D科幻喜剧今日上映】@导演孙周@ 手握“大小王”@王宝强@ @小沈阳@ @大鹏董成鹏@ 小鲜肉@尹正@ @成毅@ 一手好牌打响贺岁档。科幻、喜剧、感动三大看点，奥斯卡获奖团队打造视觉效果，绝对是高概念、强视觉、厚情感、笑哭你的一部佳作！ < 
祝活动能够圆满成功在路上的朋友，你们都要注意交通安全哦@李晨@:丰台交通支队12.2交通安全宣传活动！	今天12.2活动现场的工作人员起的好早啊，就是风有点大再大的风也阻挡不了易车之道积极做公益、关注交通安全的热情。为工作人员点赞希望今天的12.2全国交通安全日活动能够圆满成功 
很高兴与萧邦度过一个这么美的夜晚@范冰冰工作室@:璀璨之物和永恒之美，都是当晚最耀目的光芒。化妆@胡議尹@ 发型@化妆师高建@ 服装@闵塔鲨@ 手袋@路易威登@	昨晚，@萧邦Chopard@ 在北京SKP举办的私人晚宴上，全球品牌形象大使@范冰冰@ 佩戴Chopard萧邦高级珠宝、腕表惊艳亮相，奢华的钻石光芒流转间尽显高贵典雅。@范冰冰工作室@ @范冰冰粉丝团@ 
吃吧  别玩手机了养爪子呢	 今晚吃货特辑，在此谢过陕西人民盛情款待的美食！我要吃，吃吃吃！ 
坏蛋必须死,票房必须好!11月27全国公映，就在明天!	11月27日全国公映！看@陈柏霖@ @孙艺珍@ 相爱相杀，@乔振宇@ @Actor申鉉濬@ @杨旭文@ @丁文博可以@ 组Running Boy嗨翻济州岛！@那个哪吒@ 孙皓导演，@冯小刚@ 姜帝圭联合监制。试映口碑爆棚，即将“大闹”影院，与你不见不散！好人有好“抱”，是好人的都要来看哟~ < 
风格新开，先于街头 @范冰冰工作室@:运动街头融合全新风格，型不型？[擠眼]	打碎运动装和街头服饰的设计元素，抛出新式streetstyle。@范冰冰@ 告诉你只要有风格，穿什么，型什么。  
被暖到了，北京见！@蔡康永@:能够知道在意的女生喜欢什么，那是男生的运气啊 。????亲爱的，佳节快乐 。	那天在台北的一间咖啡厅，看到墙上这张画，很喜欢，店员一时联系不上画的作者，没法售卖，很遗憾的离开了。今天突然收到一个大大的箱子，康永哥寄来的圣诞礼物，打开竟是这张画，太惊喜我不记得什么时候无意和他提起过这个小小的喜欢，贴心的康永哥，好感动。@蔡康永@ 
我信你!	几年前.一位没文化一条片没拍过家伙吹牛屁自己能够演绎最美.谁都当他放一个屁.只有一个人相信.并赋予他无限信任.正是这种力量让人类执着地追求,敏锐地发现,自觉地创造,令一切无限趋近完美.这就是天地间一切的最美,“相信”之美.永恒无极,至高无上.这些年赋予我“相信&quot;的她就是最美< 
想看	  终极预告来袭！冰湖之战究竟为何引起？规矩会为何而改？属于老炮儿的江湖是否还在？豪华阵容助阵冰湖一战，12月24日，见人心！@管虎@ @冯小刚@ < 
我就是胖子，请不要欺负胖子！而且，胖子是牛牛的兄弟，简称胖牛	@刘天佐@ 一直是个努力的胖子，勤劳的胖子，可爱的胖子！但是你们应该知道，千万不要惹一个胖子… 
推荐关注@蔡康永@:对于电影，如同美食，就算没空吃个遍，翻翻菜单也开眼 !   @电影人程青松@:《21世纪最好的150部电影都在这里了》，关注就可以看到	推荐关注：青年电影手册微信公众号 dianyingshouce66 
这位姑娘，你太可爱了！祝你圣诞快乐！@冰冰晨报官博@:  晨哥	腾讯白皮书，我想说这个主播也是拼了！ < . 
救一个，是一个，做零成本的慈善	“爱里的心”是@范冰冰@ 与@陈砺志@ 2010年共同发起的公益项目，成立六年来共救治18批204个孩子，对于每一个孩子都是一次新生，但范冰冰却只简单地说：能救一个是一个，做零成本的慈善。更多内容：< 有爱的故事：< 
你们的药真的都不能停！@李晨@:倒计时2天	大黑牛，让冰冰给你喂药@李晨@ < 
一年了，好快。	开播一周年，创造了一个收视神话。作为中国首部破百亿点击的电视剧，武媚娘内地收视率前期平均破2后期平均破3 单集破4破5；台湾平均2.24 单集破3破4；香港平均25.20 大结局平均33点最高37点,一路飘红成绩斐然；感谢大家一路支持，戏里的故事已结束，戏外的人生依旧精彩。 
我在上海挺好的	“我现在外地挺好的，爸爸妈妈不要太牵挂…”最新推广曲《一封家书》，好妹妹乐队（@秦昊Jeff@ @张小厚Terry@）翻唱@李春波@ 经典名作。感人肺腑，让人想家…1月1日，一切都好，暖冬贺岁，提前回家！@张国立@ @姚晨@ @窦骁@ @陈赫@ @叶一云@ @小演员王少雍@ @导演张猛@ < 
人真的不能这么不善良。法庭见。	今日有不良媒体及个人在微信、微博、网站等平台上，使用PS修图手段移花接木，发布以范冰冰形象为主的虚假淫秽信息和图片，并进行恶意传播。对此范冰冰工作室严正声明： 
感谢国剧盛典，感谢安徽卫视、光线传媒，感谢冰邦的一路支持，荣誉属于每一位为《武媚娘传奇》付出努力与汗水的工作人员！谢谢大家！	恭喜2015年度“视后”范冰冰！为《武媚娘传奇》再添一枚至高荣誉！感谢国剧盛典和观众们的喜爱与肯定 
我是你的兄弟，也是你的honey！@范冰冰工作室@:大花臂帅炸天！ 摄影@陈漫ChenMan@ 化妆 @胡議尹@ @唐子昕@ 发型@化妆师高健@	你即刻就能买到！@范冰冰@、@李晨@ 携手登封，演绎雅痞情侣风尚，情人节要甜也要酷！天猫&gt;&gt;&gt;< 微店&gt;&gt;&gt;< ???????? 
与zigor先生的交谈更像是朋友间的对话，愉快轻松，期待下次再见@范冰冰工作室@:谢谢zigor 先生，开心的交谈，下次见！	Happy to see my interview with @范冰冰@ in the cover of South China Morning Post sunday magazine / 真的很开心我对范冰冰的采访登上@SCMP_南華早報@ 的封面。@范冰冰粉丝团@ @范冰冰工作室@ Read here: < / 
为爱付出，用心做事，我们一起继续努力	公益时报的2015年度公益100人，我们的两个合作伙伴范冰冰 、赵薇#V爱.白血病基金# 名列其中，很开心她们做的事情被社会关注到，很感谢她们为心脏病和白血病患儿所做的一切。 
这位妹子好白哟，请问是叫杜思燕，还是杜冰冰？	今天《高跟鞋先生》的首映礼很成功，感谢朋友们的支持，自己躲在影院的角落里，无比激动，大家一笑我就热泪……今天太开心了 
哇@向佐JackyHeung@:谢谢各位支持我的人	《男士健康》杂志携手 @陈漫ChenMan@  南下香港拍摄2月刊封面人物 @向佐JackyHeung@  ，戏里的他眉峰紧锁，眼神凌厉，而现实生活里他完全是巨蟹座无微不至的体贴。 
你敢说你心里没有偷着笑？→_→@冰冰晨报官博@: →_→	刚看完视频 ，马上翻了翻箱底儿存货，原来牧哥哥杠的是真人啊，一直以为是道具 
已试穿，五星好评！趁还没卖光，赶紧再给我囤几件！	CHRIS BY CHRISTOPHER BU S/S 2016 RTW ：SWEETILICIOUS @ChristopherBu@ 2016春夏成衣系列。新上线官方购物网站: SHOP.CHRISTOPHERBU.COM.CN 官方客服号：ChristopherBu Photographer:@黄璨CAN@ , Make-up:@吕燕LVYAN@ , Hair:@paulstudio杰森@ 
时间不负有心人@向佐JackyHeung@:謝超哥	抱歉，此微博已被作者删除。查看帮助：http:t.cn/Rfd3rQV
太珍贵了！时光。	“范冰冰被门夹、李晨飙泪、石头6个月首秀、孙俪突袭邓超、羽泉砸场子、黄渤闫妮劲歌热舞…超访独家曝光16年绝密资料。关注2月17、18日重庆卫视，收看最后两期《超级访问》特别节目。#范...”我的秒拍作品，一起来看~<（使用#秒拍#录制） 
心中的美好	【黒木敏幸：不能带她走遍世界，就把世界带她面前】他说，结婚30周年时去周游世界；她，没等到这一天就双目失明；他想，“如果有人来与妻子说话，她或许会心态平和些”。于是他便为她在家的周围种满芝樱整整20年，每朵花都是他的心。“能听到很多人的声音很幸福。”她说。< 
鹏鹏也快乐！快回家抱着香香软软的小情人吧！	情人节快乐。 
情人节的好选择！	情人节，最好的选择！《高跟鞋先生》2月14上映啦电影让人又笑又哭又感动超极给力 < 
这间套房让我有回到家的温馨！Merci！@范冰冰工作室@:在这里完美邂逅穿着龙袍、仙鹤装、CHINA瓷、花仙子的范冰冰！希望每一个在范冰冰套房入住的旅人都能拥有独特别致的愉快假期！	作为戛纳克鲁瓦塞特大道上的标志性建筑，卡尔顿洲际酒店以我们的个性化套房致敬第七艺术，例如格蕾丝·凯利套房，肖恩·潘套房... Voilà!  范冰冰套房是我们酒店第一间以亚洲女演员命名的套房。快来我们酒店度过一个舒适愉快的假期吧！ 
亲亲小肚肚!	一只成精的鹦鹉，知道了主人太多的秘密，真怕主人会杀鹦灭口 < . 
十年的老朋友再次合作，幸福，幸运！@范冰冰工作室@:谢谢赵老师，感谢好故事好角色和最好的工作伙伴，“李雪莲”会更加努力！	十年一觉扬州梦，再见@范冰冰@ 已不是十年前的杨玉环了。 我被她的“李雪莲”惊到了，她将这个乡村女人的固执坚韧滴水穿石地渗透进角色之中，像打磨玉器的工匠，不慌不忙，成竹在胸。@刘震云@ 老师的小说总让人笑而带泪，那些小人物如此普通但每个人的命运过目难忘。@冯小刚@ 导演带着“六爷”的严谨和细 ...
最后那张只有聪明人能看到你看评论里大伙都看到了！@李晨@:少一张啊……	终于九张 
导演，你这是第三回上台帮我领奖了，第一次是«苹果»在哈萨克斯坦，第二次是«观音山»在东京，第三次是«万物生长»在柏林。也是因为你，让我对拍电影这件事有了更不一样的体会！放心，下次提名，我还是不会去的@李玉@:冰冰，你是没来就获奖的节奏，还有一次是东京电影节	“我要用尽我的万种风情，让你在将来任何不和我在一起的时候，内心无法安宁。” 你还记得《万物生长》里，那个风情万种，柔情似水的柳青吗？在，《万物生长》得到了高度的好评。李玉范冰冰的组合，再度在国际曝光。范冰冰凭借此片，荣获了最佳女演员的奖项。恭喜@李玉@ @范冰冰@ 
期待小新版的赵子龙！帅！	二月二，龙抬头，《武神赵子龙》千呼万唤始出来< 
开机大吉，期待新作！	二月二，龙抬头，樯薇盛，二度开。电影《没有别的爱》今天开机喽～ 
我想我们应该能见到！谢谢你！	我就是那么任性，只画范冰冰啊！ < 
工作结束!	终于八张！ 
支持！@谭晶官方微博@:感谢@马伊琍@ @邓飞@ 等好友对这个提案的帮助和支持！也希望大家能参与到 这个话题的讨论中来，一起将新生母亲和婴儿的呼声传递出去。????????	【谭晶提案：】今年全国两会期间，@谭晶官方微博@ 化身”新生母亲“代言人，她指出，国内不少场合，母婴室要么尚未设立，要么设置简单，通常只有一副桌椅，洗手池尿布台等几乎不存在。她建议，各级政府应将母婴室的建设列入城市规划范畴，制定标准避免有名无实。< 
10后萌娃，好稀饭! 出发@路易威登@ @范冰冰工作室@:想来挑（玩）战（耍）吗？方法很简单！活动没有门槛没有难度，性别、年龄、服装、发饰一切都是浮云，COS冰冰任意一款时装周造型，并加上话题，我们将选出5位最有创意的朋友，送上精美礼品，你还有可能得到冰冰亲手点赞哦！	今天出发，美美哒造型抢先看！小浪还“抓”到四个萌娃实力cos范爷过往的时装周经典造型，又萌又酷！[愛你] 还有要来挑(玩)战(耍)的吗？参与话题 并晒出你打造的cos造型，除了有机会拿精美礼品，冰冰还将为造型出众者点赞~ 
十二年，一个圆，祝小刚导演生日快乐！美妙的日子在后边儿！	变的是年龄，不变的是幽默。祝冯小刚导演58岁生日快乐！ 
二零一六中秋 相逢是圆	身穿高桥盾UC(Undercover)2016 S/S出席电影北京“十二年，一个圆”首场发布会，发型很仙鞋子很美，衣服很特别范爷很敢穿。看到李雪莲的预告造型只想说：我的天呐！< 
帅的我都说不出话了！	@范冰冰@ 美的我都不知道说啥了呢。 
噢！天那！快看，那是金刚芭比！@李晨@:???? @姚晨@:多么强壮妩媚的金发美人儿。????	 看惯了女生花枝招展，看过身材强健的大黑牛 @李晨@  的“艳照”吗？福利来了~ 为了合伙人@姚晨@ @唐嫣@ @郝蕾@ 创业致富也是豁出去了！ 
 我是李雪莲	一件严肃的事，可不能让它变成笑话。@刘震云@ 同名小说改编，@冯小刚@ 导演，@范冰冰@ 主演。2016中秋，相逢是圆。< 
保护每一个孩子 每一个天使！	< 
哇，也是仰角！	谁干的…sei？ 
今晚21:55锁定江苏卫视，和我一起用心聆听！	七位身怀绝技的歌手亮相 ，真假难辩的身份，扑朔迷离的表演，每个人看起来都是实力唱将！音痴vs实力者，谜底即将揭晓！究竟谁的声音能被女神看见？首期大来宾@范冰冰@ 来到的舞台辨音痴，临危不乱！走秀趴、吃汉堡、俏皮卖萌，更多精彩就在今晚21：55@江苏卫视@ 等你来看！ ...
小鹿 加油！	自己的第一场演唱会，有点儿紧张，有点儿兴奋，今晚，一起嗨起来～  
化妆，范冰冰	把彩条玩疯吧，@范冰冰@ 告诉你就是要大色块的碰撞，走在巴黎的街头，摔着长发，穿着Chris by Christopher Bu 拼色针织风衣内搭黑色连身裙，黑丝！黑丝！教材白色牛皮松糕鞋。站在街头都是这般的“傲娇”。摄影师：@章元一@ @ChristopherBu@ @范冰冰工作室@ 
哎呦！不错哟！	大家好，我叫小9，六个月啦！我家人全是超级冰邦，爸爸妈妈都觉得冰冰姐姐最美，于是我就有了这些漂亮的衣服和照片！衣服是大姨一针一线缝出来的，照片是麻麻拍的，造型是俺自己摆的@范冰冰@ 姐姐觉得咋样呢 
娜就要做一个最好的访谈节目！加油！	  今晚第二次摸底考试，我还是很紧张，咋整呢哦多客哦多客萨瓦迪卡要不是你们，我也没有勇气去尝试迈出这一步，去做和以往十几年的综艺完全不一样的表现方式，我来啦，去接受去面对去挑战去找方向去超越自己去拥抱发光时代好啦《发光时代》是软广啦今晚东方卫视十点见！ 
预祝科雷嘉大卖！我们一起去挑战！@范冰冰工作室@:收到美图啦！恭喜上市更祝科雷嘉大卖	#挑战不是逞能，是本能#昨日，东风雷诺科雷嘉在北京激情上市！代言人范冰冰小姐也来到了现场。为了满足大家的愿望，特奉上冰冰美图一套，话说，冰冰是不是美美哒 @范冰冰@ @范冰冰工作室@ 
那天，宝宝确实是太饿了，而且宝宝也真是爱玉米！	【太饿了！范冰冰街边豪放啃玉米】当天，范冰冰身穿黑色毛领外套匆忙来到活动现场，抵达活动地点后，范冰冰率先下车，身后跟着多位助理，气场强大。可是将镜头拉近一看，发现女神手中还握着一个吃了一半的玉米，或许是时间匆忙实在没有时间吃饭，一向爱美的范爷居然不顾形象地在马路上豪放吃起了玉米， ...
女孩在外一定要注意安全！望此事能彻查！如果大家看到身边有女性呼救，请马上、立刻拿起你的电话报警！	整理了我被劫持的经过和事态发展到现在的结果，希望对看到这个文章的朋友有所帮助，并且让更多的人转发扩散，让身边的女生看到我的案子有警觉心，也希望有关部门看到这个文章之后，能给我一个有诚意的答复！<br/><  <
好吧，老爸终于圆梦了，小时候就听他在家里唱，在台上唱，在比赛中唱。也是因为那时我太小，爸爸要照顾家庭，沒有继续追逐他的梦想，但对唱歌的热爱，一直在他心底从未放弃！谢谢制片人力栋哥给了我老爸一个圆梦的机会，说真的，他唱的比我好多了！祝收视长虹！	范爸范涛献唱《武神赵子龙》在范爸爸范涛录制《子龙》时，@范冰冰@ 一家人皆亲上阵陪同，用实际行动来支持范太爷此次的歌手圆梦，《子龙》真是实现范太爷的范特西歌手梦呀 < 
2016国庆，爵美相见。	惊鸿初见，皆为虚幻；九月三十，燃魂一战。电影今年国庆，与你共赴迟来之约。 <  <
今晚九点，敬请期待	明天又是很久不见的了，一般带这个话题，就是有重磅炸弹投放，在爵迹的漫长宣传期中，使用这个话题的次数屈指可数，所以，明晚九点，猜猜有什么要来了……欢迎下注，买定离手。我已经开始方了，好焦虑…… 
中军哥生日快乐！结婚纪念日快乐！	中军哥生日快乐！@范冰冰@ @冯绍峰@ @李晨@ 摄影：我 
挑战一路向前!@范冰冰工作室@:挑战开始，一起奔跑！	作为东风雷诺科雷嘉的代言人，范冰冰小姐也出现在马拉松的赛场，与东风雷诺跑团进行亲切互动。这无疑为挑战之路上的跑友们又增添了无限动力！@武汉马拉松@ @范冰冰@ @范冰冰工作室@ 
每天让三个人因你而微笑！	【生命太短暂，我没时间讨厌你！】①别人怎么看待你，完全与你无关。②尝试逗他人开心，每天至少让三个人因你而微笑。③不要把你的生活跟别人比较，你不知道其他人走过什么样的路……与人相处需要的心理准备和处理技巧↓↓ @这里是美国@ 
不错哦@范冰冰粉丝团@: 画得真棒～	希望明天复试一切顺利。  
十九岁的天空	不整容的范冰冰，父母给了她哪些基因：韩国导演金相辰说韩国人喜爱范冰冰，虽然她只出演了一部韩国电影，但她很漂亮，不是整过容的。金导演这句话，于我心有戚戚焉。 2000年范冰冰出演《秦始皇...文字版&gt;&gt; < （新浪长微博&gt;&gt; <） 
学长，放学先别走，我们来聊聊人森。@李晨@:校服……	【校服版海报】@姚晨@ @李晨@ 校服装尽显年少青涩，目光纯净却斗志昂扬，背景的自由女神如同未达成的梦想遥远虚幻，而清晰的美元则暗示着与@唐嫣@ @郝蕾@ @郭富城@ 的相遇和梦想的实现。时间就像邮票，会带我们到达梦想的彼岸。4月29日，电影《梦想合伙人》带你从白手咸鱼到亿万富翁！ 
下午4点等着看你，加油，鸡血女王！	<  我要做人生中的第一次直播啦！吓死人了，紧张死我了……请微博里的朋友们帮我壮壮胆，到时候请一定给我撑个人场[抱拳][抱拳][抱拳]给打赏更好，全部打赏一直播都不留存，捐给 的芭莎乡村救护车项目。 @韩坤HK@ @时尚芭莎@ @芭莎能量@  ...
开奖！@520小肥羊范@ @我是小烨儿啊_@ @冰蓉抹茶@ @嘟嘟冰棒@  @Anna_劳@ 每人一个签名手机壳，@小浣熊爱冰冰@ @PAFAFAFAF@ @啊不必呦@ 每人一个羊驼公仔，希望你们喜欢哦@范冰冰@:恭喜大哥刷新成龙电影内地票房纪录！转发中选八位朋友，五位送签名手机壳，另三位送签名羊驼公仔。	[玫瑰][玫瑰]能打能笑的成龙大哥+自带助攻洪荒之力的范爷@范冰冰@=票房纪录更上一层楼！传奇还在继续，为观众带来欢乐的初心也不会变，我们奉陪到底。 
恭喜大哥刷新成龙电影内地票房纪录！再来一轮抽奖，转发中选八位朋友，其中五位送每人一个️签名手机壳，另三位送出我签名的羊驼公仔。	[玫瑰][玫瑰]能打能笑的成龙大哥+自带助攻洪荒之力的范爷@范冰冰@=票房纪录更上一层楼！传奇还在继续，为观众带来欢乐的初心也不会变，我们奉陪到底。 
想吃什么告诉我	 好吃的东西就是要一起分享才会觉得更美味！@范冰冰@ 再次立于食物链顶端，敏锐的嗅觉分辨美食，为了美味自组小乐队“卖艺”挣钱，可爱的捣乱让对手哭笑不得，立于高处的她能否锁定关键呢？本周六20:30跟着学厨艺！ 
爵迹！ 9.30	  由郭敬明执导，范冰冰、吴亦凡、陈学冬、陈伟霆、郭采洁、林允、严屹宽、王源、汪铎主演，杨幂特别出演，李治廷友情出演的[爵迹]曝出蓄势待发版海报。在此组3D高精角色海报中，11位王爵使徒集结亮相，神态动作仿佛决战前夕。影片将于9月30日公映。 
支持!	为了喜欢的角色而努力是一种幸福，很高兴在《微微一笑很倾城》中找到这种幸福。8月12日，电影即将全国公映，希望这部电影能够带给大家简单心动的甜蜜，也希望这个贝微微能符合你们的期待。   < 
岿然不动李雪莲，迷之定力求：李雪莲到底有多重？	德艺双馨“老干部”，遭遇“离分”李雪莲。双方拔河愈十年，平静生活乱成团。你来我往谁有理，戳开大图有惊喜！@冯小刚@ @范冰冰@ @郭涛@ @大鹏董成鹏@   @于和伟@ @张译@ @李宗翰@ @演员赵立新@ @范伟@ @道哥刘桦@ < 
哥哥，我们一起去战斗！	偶终于有个亲妹妹了@范冰冰@   @郭敬明@    
一个百分百的幻想世界，一群依靠脑洞拍戏的人	【《爵迹》片场真人秀之使徒修炼手册(使徒上)】又来了！@范冰冰@ 变身女战士、@陈学冬@ 成长力MAX、一不小心就中了导演套路的@杨幂@ 、@林允Jelly@ 成剧组杀手、好奇宝宝@李治廷@ 以及一言不合就跳舞的@TFBOYS-王源@ ……没想到高冷照片的背后是这样的画风→< 
争一寸赢一寸 天下与你江山傲岸	首款海报震撼曝光，@范冰冰@ 一袭傲雪白衣清洌倾城，史上“第一女首富”巴清的传奇人生即将开启。@高翊浚@ 
915，等看至尊宝！@韩庚@:9月15日，至尊宝在影院等你，不见不散！	公布终极预告< 预告以酿成悲剧的牛府婚礼开始，@韩庚@ 所饰孙悟空发誓不再辜负爱人，而@唐嫣@ 所饰紫霞则一心改写悲剧命运。白晶晶@Karen莫文蔚@ 春三十娘@鍾欣潼@ 三藏@吳京@ 牛魔王@张超Juck@ 铁扇公主@谢楠@ 红孩儿@UNIQ_一博@ 等人也集体亮相。影片9月15日上映 
914！追！	914！914！914！曹保平导演最新作品《追凶者也》提档啦，并发布“爱是元凶”预告和“追凶”全阵容海报！@刘烨@ @张译@ @DuAn段博文@ @王子文Olivia@ @谭卓@ 陷入N角恋大战？ 预告片戳→< 
心在，和你，最棒的李宇春！	 大家都到现场了吗？ 
谢谢好朋友来助阵，第二季舍不得和你们说再见	 第二季最后一期周六晚上就要播出啦！范冰冰身穿Viktor &amp; Rolf 2016秋冬系列高级定制，和李宇春一起，用歌声为本季节目画上一个圆满的句号。经历了欢乐与感动、困难与挑战，作为挑战者联盟的一员，冰冰和朋友们挑战了一切不可能！继续加油吧，挑战者！服装：@闵塔鲨@  妆发：@张浩然R-studi@ ...
中国女排！	【此刻，一起转发！中国女排！太！牛！了！】中国女排3-1战胜荷兰队，顺利晋级决赛！两队奉献了一场精彩的比赛，激动人心！中国姑娘们太不容易了！传递！祝贺中国女排！中国加油！ 
为好朋友助阵义不容辞！很开心能一次看到这么多有意思的设计今晚一定要锁定东方卫视，给你好看	迎来首期灵感女神，我的好朋友@范冰冰@，以旅行中的氢气球为主题，把最有爱的设计送给最有爱的人[爱心] 
战友们北京集结，战斗在即！9月30日，电影院见！	范冰冰身着Alberta Ferretti 2017早春系列，出席了电影《爵迹》“与子同袍”发布会。鬼山莲泉和战友们团聚了，他们将开启守护荣誉和真相的燃魂之战！9月30日，电影院见！  服装：@闵塔鲨@ 妆发：@张浩然R-studio@ 摄影：@七明多@ 
李雪莲就在背后，好好看看你们这众生相！	 由冯小刚执导，刘震云编剧，范冰冰领衔主演，郭涛、大鹏、张嘉译、于和伟、张译、李宗翰、赵立新、田小洁、范伟、刘桦等出演的[我不是潘金莲]曝“有戏版”海报。丰子恺式国画风格，海报不见李雪莲，却处处可见李雪莲，是为“李雪莲的男人”众生相。影片9月30日上映。 
星际迷航3，9月2日记得去看哦！	《星际迷航3》发布终极预告，“柯克舰长”克里斯派恩向中国观众致以问候→< 预告中不仅有太空中的高速追逐，舰长还在敌军领地狂飙摩托，配合带感节奏犹如“宇宙版速度与激情”；结尾时进取号飞过之处引爆炸连连，视效引人期待。将于9月2日(明日)上映，电影院走起？ 
礼物@范冰冰工作室@:最好的生日礼物！	恭喜!!!由冯小刚执导，刘震云编剧，范冰冰主演的入围第64届圣塞巴斯蒂安国际电影节主竞赛单元，并将作为唯一一部入围华语片，角逐电影节最高奖项“金贝壳奖”！同时范冰冰也入围最佳女主角，而这也是范冰冰第四次入围国际A类电影节此前范冰冰曾获得国际A类电影节东京国际电影 ...
新的开始！为了更多需要帮助的孩子们！@陈砺志@: 资助对象从西藏阿里扩大到全国，符合资助条件的都可以下载申请表，求转发，转给有需要的孩子，希望足够多的人看到。	 项目组正式将先天性心脏病患儿救治筛选范围从西藏阿里扩大到全国，首例对象已经顺利完成手术，希望此项条款可以帮助到更多有需要的孩子。救治申请条件请戳下图，申请者请下载申请表<，填写后邮寄并同时发送电子版至邮箱。 
导演就像巧克力，小身材，大能量！我是鬼山莲泉	【《爵迹》片场真人秀之使徒终极试炼（使徒下）】虽然一直嘻嘻哈哈，但欢笑的背后，是辛苦的汗水和泪水。感谢所有演员和上千个幕后英雄，我们一起完成了从未有过的挑战，非常艰难也非常值得！9月30日献上最终的答卷。  < 
我们是点点一家人	【《爵迹》曝片场真人秀】电影《爵迹》曝光两支片场真人秀视频，王爵’s行走的荷尔蒙<与使徒修炼手册<，真实记录影片主演范冰冰、吴亦凡、陈学冬、陈伟霆、郭采洁、杨幂、林允、严屹宽、李治廷、王源、汪铎与导演郭敬明以及幕后的工作人员，从进组训练、扫描3D人 ...
慈善从不是口头承诺，而是一次次的身体力行！很开心看到一群有爱的朋友们为爱联盟，让温暖继续传递下去，希望这份爱永远延续！	炸裂天，活久见！首发亮相啦！2016.9.9#慈善争锋，为爱联盟#震撼全中国，史上最强巨星战队，一切为了爱。全球首创，敬请期待……@时尚芭莎@ @芭莎能量@ @芭莎公益慈善基金@ 朋友们届时看@腾讯视频@ @一直播@ 最后晚会呈现@浙江卫视@ 国庆黄金档播出！！！ 
李雪莲，我们又见面了！	多伦多时间9月8日晚，冯小刚、范冰冰、郭涛、大鹏带着《我不是潘金莲》亮相第41届多伦多国际电影节，众主创一起出席该片全球首映礼。《我不是潘金莲》率先亮相本届多伦多国际电影节特别展映单元。首映礼上穿着Elie Saab2016秋冬高级定制的范冰冰和戏里土得掉渣的村姑李雪莲，她们一起来了！服装：@闵塔@ ...
雪莲进城了！要你好看！	 雪莲@范冰冰@ 要进城，导演@冯小刚@ 要征战多伦多，事关重大，不敢瞒情不报！@郭涛@ @大鹏董成鹏@！！ 
我说我是窦娥，冤！	 国际版预告冲突再升级！男人们为何谈李雪莲而色变？问题循环往复却得不到解决，这出戏才刚刚拉开序幕！@冯小刚@ @范冰冰@ @郭涛@ @大鹏董成鹏@  @于和伟@ @张译@ @李宗翰@ @演员赵立新@ @范伟@ @道哥刘桦@ < 
雪莲都被这帮人气糊涂了！	台上武生演戏，台下雪莲斗气，李雪莲@范冰冰@ 化身“女侠”，“磨刀霍霍”闯天涯。雪莲的男人们@郭涛@ @大鹏董成鹏@   @于和伟@ @张译@ @李宗翰@ @演员赵立新@@范伟@ @道哥刘桦@ ，都怕了吗？@冯小刚@ < 
瞅你咋地？@大鹏董成鹏@: 你瞅啥？	神态各异老干部，呆萌雪莲在中间。众星捧月是焦点，万绿丛中一点红。@冯小刚@ @范冰冰@ @郭涛@ @大鹏董成鹏@   @于和伟@ @张译@ @李宗翰@ @演员赵立新@@范伟@ @道哥刘桦@ 
很高兴在花椒之夜认识了这么多可爱的新朋友！科科，原来你不只球打得棒，长得帅，还辣么聪明！乒乓球我学定了！	抱歉，此微博已被作者删除。查看帮助：http:t.cn/Rfd3rQV
分享一个从古代来的我	爱芭姐你怕了吗，眼神锁定这个重磅花絮！能让你醉心场景的古色古香，沉迷@范冰冰@ 的傲娇内敛，将古典与时尚完美演绎，每一帧都有无限禅意~  < . 
笑看方圆 来日方长 MV首发！	 方圆版推广曲《来日方长》MV首发！具有东方气质独特魅力嗓音的@黄龄@ 和情歌王子@薛之谦@ 深情唱腔的诠释，配合电影画面，情深似海。@冯小刚@ @范冰冰@ @郭涛@ @大鹏董成鹏@  @于和伟@ @张译@ @李宗翰@ @演员赵立新@ @范伟@ @道哥刘桦@  < 
“李雪莲这个事，我们觉得她是小白菜，她前夫说她是潘金莲，她自己觉得自己像窦娥。”	 今天看了成片，你冰完全没有往日的影子，她就是李雪莲，她就是那个身含冤屈数十载的农村妇女，有几场爆发戏演的很好，既不多一分也不欠火候，状态刚刚好。我就不剧透了，敬请期待九月三十日影片上映吧 
BAZAAR  Anniversary  走！来一场时空旅行！ @范冰冰工作室@:从古色古香穿行到梦幻太空，从《我不是潘金莲》中的执拗村妇”李雪莲”跨越至《爵迹》里的双身王爵“鬼山莲泉”，双莲并行，无尽变幻！930等你共赴时空旅行！	 30周年纪念双刊封面曝光！@范冰冰@ 完美演绎时空旅行视觉盛宴，古典东方美和未来科技感创意碰撞。芭姐见证出道近20年的她完美蜕变，蓄势收获多部电影，为未来积累无限能量！摄影@陈漫ChenMan@ 总策划@左敏洁KT@ 形象@范晓牧Xiaomufan@ 编辑@涂山曼倩@ 戳链接购买： ...
“答案不过是场好觉睡醒”，好听！喜欢！	毛遂自荐的结果是...<br/>第八张专辑第一首歌提前诞生...<br/>《来日方长》<br/>也是我难得的合唱歌曲... <br/>希望 你们喜欢...<br/>@冯小刚@  @范冰冰@<br/> <br/>方圆版推广曲《来日方长》今日上线... <br/>< 
好家伙，时光从来不会辜负你！9月是好的！@冰冰晨报官博@:  还有好多精彩的没放出来！期待	啊！录下来了！声音有点儿小 < . 
914花椒见！@花椒直播@	<  在@花椒直播@ 首次开播，冰邦们准备好了吗？花椒见！ 
不管外面的的世界如何狂风暴雨，但我们的日子依然细水长流，这是美好！	中秋节、电影节、生日、入围、几个关键词成了最近同事朋友相继讨论的重要议题，一系列扎堆的事件也让行程变得并不轻松。而我们的主角儿却一心惦记着远方的胖儿，常常被提及的总是我猫如何，当然，大头也在其中。<br/>举重若轻的人往往是快乐的，可我知道，这轻的代价又是多少付出与努力，导儿曾经说条件艰 ...
谢谢海涛继续打卡，继续巧克力腹肌哟	祝我的女神生日快乐！长生不老！啦啦啦啦????@范冰冰@ 
谢谢导演的祝福，鬼山莲泉已经准备好为了9月30号开启战斗模式啦！	亲爱的冰冰，生日快乐！因为爵迹我们认识合作，让我更加了解你。工作上的你认真敬业，私下生活中你的可爱又超级义气！祝你一切顺利，永远开心幸福，一切好运气都伴随你！@范冰冰@ 
baby baby baby ooo 哈哈 大头症的感觉不错诶！谢谢亲爱的	@范冰冰@ 冰冰姐生日快乐！图片代表我想说的一切???? 
爱你！都好好的！	Dear大美妞！願善心、真實的妳，永遠活得自在快樂，擁有最多的幸福，因為妳值得！嘻！今日離妳太遠，只能送上香吻一個，Enjoy!生日快樂！！@范冰冰@ 
走！一起奔个月瞧瞧去！	明月幾時有⋯自己上去看看不就結了嗎 
公道，祝福已收到，但离分的事儿咱还是得说清楚	生日快乐，@范冰冰@ 。 
放假第一天大家都在哪儿过呢？祝大家中秋节快乐！离家在外的朋友们记得给家人打个电话哟	昨晚的直播回放链接????< 没赶上直播的小伙伴们快来看！ 
爵迹开始预售了，鬼山莲泉必须全力支持新人小四首秀！唉？魂兽雪刺为什么是麻辣小龙虾，不该是冰雪俊美的麻辣小蝎子？	猜中我到底演什么了吗？答案：我，就是银尘的魂兽雪刺！和我主人一样冰雪俊美！不用赞我，我会骄傲。你们也可叫我诨号——麻辣小龙虾 重点来了：爵迹预售今日全面开启！求支持新人银幕首秀！预售传送门→【微票儿：<】【猫眼电影： ...
洒满阳光的圣塞巴斯蒂安，真适合吹吹海风放放空	在天气美好的海边，捉到一只从银幕里跑出来臭美的李雪莲 
很荣幸很高兴！高兴大家喜欢我们的电影，感谢多伦多电影节，是导演和所有主创一齐努力的结果！	@冯小刚@ 导演的《我不是潘金莲》获国际影评人费比西奖(特别展映单元)，同时宣布由9月30日改档至11月18日！本片由刘震云编剧，@范冰冰@ 主演 @郭涛@@大鹏董成鹏@  @于和伟@@张译@@李宗翰@@演员赵立新@@范伟@@道哥刘桦@ 出演。目前冯导和冰冰正征战圣塞巴斯蒂安电影节 
在圣塞巴斯蒂安的海边，看李雪莲的故事	《我不是潘金莲》亮相第64届圣塞巴斯蒂安国际电影节，入围本届电影节主竞赛单元，范冰冰也凭借该片提名最佳女主角，“雪莲”出席电影节开幕式，第二波高清图奉上！服装@闵塔鲨@   摄影@章元一@ 
谢谢晓雪姐！girl power@晓雪@:大处女座女神冰冰生快	范爷是我们给她的称呼，女神是我们对她的喜爱。纵使红毯上光芒万丈，事业上功成名就，她还是自己心中的那个小女孩。她拥有所有女孩儿想成为的模样，更拥有一颗不惧怕时间流逝的强大内心。 她演绎着这个时代的girl power，更担当着自己人生的女主角、并且永远保持女孩儿般的纯净和 ...
晚上见！记得上@花椒直播@ 来聊天！	获奖之后，你发了一条微博，感谢了很多人，看似一切顺理成章，可这一路走来，其中多少艰辛，却只字未提，你依旧是那个面对一切都淡然微笑的范冰冰。恭喜花椒首席体验官@范冰冰@ 荣获圣塞巴斯蒂安电影节影后！9月28日18:50，《我不是潘金莲》众望所归庆功酒会，台前幕后花椒全程直播！花椒ID：59819854  ...
不畏险阻，不忘初心 @范冰冰工作室@:每一段故事，每一句话，都和前进路上的你一起共勉。冰冰聊得很尽兴，没看节目的小伙伴快戳➡️➡️	“长得漂亮的人挺多的，人人都可以靠脸吃饭，为什么没有人成为范冰冰。”这个世界，从来没有无缘无故的成功，敢于跨越那些常人无法逾越的刀山火海，才有可能成为独一无二的自己。@范冰冰@@陈砺志@@学生孙璞@ @范冰冰工作室@@湖南卫视贴吧@@范冰冰粉丝团@ < 
真好，永远都要幸福快乐！@谢娜@:五周年快乐， 我的快乐分你一半	五年了，我们重回香格里拉，依然纯净快乐着. @谢娜@   < 
燃爆！@冰冰晨报官博@:  燃 @李晨工作室@:少年的中国没有学校，他的学校是大地和山川。  9月26日，北京卫视黄金档等你！	年度良心战争题材大剧好家伙曝光“燃”版预告，一场关于信仰的博弈即将展开，什么是种子？什么是惊蛰？三天后北京卫视即将揭晓，四年等待，时光决不负你。< 
今天晚上在@花椒直播@ 等大家！@花椒直播@:友情提示，< ！  < @范冰冰工作室@: Valentino2017春夏大秀，冰冰这次会有什么造型新灵感？明晚揭晓记得一起来花椒聊天哦！	 十一假期开始了，如何战胜朋友圈99%的好友？一键解锁巴黎10月2日21点@范冰冰@ 将在花椒直播全程独家为你揭秘巴黎时装周的台前幕后，锁定花椒ID：‪59819854‬，@范冰冰工作室@ 一键关注：< 
妹控，这样的哥哥我也想来一打！	看了这组图才知道《爵迹》里到底有多少种感情，严屹宽对范冰冰是真爱了，这样的哥哥请给我来一打！ 
刚落地巴黎，开机，收到这个好消息，入围已是最好的礼物！祝贺我们雪莲剧组！时光走得好快，记得上一次拿金马是在2007年的《心中有鬼》，九年了，有意思！	金马奖入围名单公布，《我不是潘金莲》最佳导演、最佳影片、最佳女主角、最佳改编剧本、最佳音乐提名！@范冰冰@ @冯小刚@ 刘震云老师，@华谊兄弟电影@ 
感谢三四百位特效老师们的爆肝付出，导演两年多的努力终于有了成果，为我们爵迹大家族骄傲！影片已经上映，电影院快快走起	【电影《爵迹》之十大极限挑战】拍了一部电影，我整个人都快变成技术宅了这么久的努力搬上了大银幕，除了银幕上我们能看到的诸位外，还有许许多多幕后的工作人员为《爵迹》付出了很多心血，欢迎大家收看本视频：对郭敬明的十大控诉！ < 
亚斯蓝帝国第一个双身王爵，鬼山莲泉。	《爵迹》燃爆了！鬼山莲泉果然不凡！戏外的双身王爵也是美的不要不要的???????? 
《爵迹》今天上画！大家去电影院感受亚斯兰帝国吧！	电影首映，冰冰身着Valentino2016早秋系列亮片裙亮相红毯，与导演郭敬明，以及亚斯蓝帝国的战士们一同出席首映礼，大家一起揭开了《爵迹》的神秘面纱！小伙伴们买好票了吗？让我们同见证时刻！服装：@闵塔鲨@ 妆发：@张浩然R-studio@ 摄影：@七明多@ 
纪念套票在这里，假期快结束啦，你们都去看爵迹了吗？@范冰冰工作室@:好消息！“双莲冰至”套票礼盒追加200份，今日11点准时开售！上次没抢到的冰邦们，加油哦	 微影时代携手范冰冰工作室、可可影打造的“双莲冰至”精品套票礼盒9月29号在娱票儿商城独家开售创下930套3分钟售罄纪录！小票儿听说很多人手慢网速渣没有抢到？今天中午11点，双莲再开！这次不要再错过啦，拿起手机扫码开抢吧！ 
秋来了，喜欢这件黑色外套，暖和[好棒]	 @范冰冰@ 漫步在巴黎街头，我们脑子里曾出现的冰冰是多样的，或娇媚、或飒爽、或英气，可唯一不变的是大家爱“里”的心。冰冰，十一月《我不是潘金莲》北京约。 
莲泉大人和她的卫队长，注意，他在发光！	 某p的（自动马赛克白边 
今天继续找信号，19:00我在@花椒直播@ 等你们！	 冰邦小可爱们，首席体验官@范冰冰@ 再次驾到巴黎时装周了！ 一想到美到发光的冰冰又要在直播间翻牌了，小椒椒已经在脑中列了10个问题~今晚19:00锁定花椒ID： 59819854，做好准备抢占前排，我们不见不散! @范冰冰工作室@ 
你们仨！????????????@angelababy@:恭喜你呀	三个人的旅行，以后还要一起很多次，感恩，媳妇儿～ 
什么时候可以有女车手参赛？我想驾电动一级方程式赛车！环保，特别喜欢在赛场里有交警叔叔催着我超速，风弛电掣！@Enova@ @FIAFormulaE@:转发微博	 2016-17赛季国际汽联电动方程式锦标赛（FE）揭幕战本周日将在香港中环赛道正式打响，Motorsport中文网就新赛季的参赛车队进行介绍。@FIAFormulaE@ < 
上班福利，随机抽取送10位朋友每人一份	十一假期之后上班第一天，大家打起精神上班啦！冰冰决定从转发此微博的朋友中，选出10个人，送给每人一份“双莲冰至”套票礼盒！ 
关于秋的不同搭配，你中意哪一种？	冰冰身着马海毛运动双排扣大衣，不同包包诠释不同感觉，演绎女性的法式优雅和温柔秋冬摄影：@章元一@ 
台词是：我麻麻不是说只走五天吗？怎么还没回来？真气人！难道她不知道这个代理铲屎官真的有点笨吗？噢！天哪！	台词是：你瞅啥呢？<br/>               瞅你咋滴？ 
张老师，好像我小时候的声乐老师！	  第29间张杰音乐梦想教室近日在上海市儿童医院正式授牌，用音乐照亮梦想的行动不会止息。29，爱与梦想共长久 < 
这三个字里面，我最喜欢中间那个！好吧！	 瘦美仙 
厉害了，我的叔	说起为什么选择范冰冰出演李雪莲，@冯小刚@ 导演在现场说：“电影在选角色之前，热心的网友向我推荐了非常多的优秀演员，唯独反对范冰冰，这极大的坚定了我用范冰冰的决心！冰冰很有灵性，结果证明她没有辜负众星捧月的厚望！”冯导看似任性叛逆，但是却独具慧眼！厉害了，我的叔！ ...
礼物来啦！@北巷屿猫@ @F口天凡@ @女神范苦艾@ @佐女乔兮@ @Lichtregen@ @Tina_自由行走的职业@ @嗨大脸和尚@ @因为你是范小瘦@ @LZ迷途的小兽@ @胡姐说@ ，鬼山莲泉和李雪莲会尽快把礼物送达你们手上！@范冰冰@:上班福利，随机抽取送10位朋友每人一份	十一假期之后上班第一天，大家打起精神上班啦！冰冰决定从转发此微博的朋友中，选出10个人，送给每人一份“双莲冰至”套票礼盒！ 
李雪莲就想“结个分”,再“离个分”,再“结个分”，怎么这么难?????	十年前的对错，十年后的结果。一群人绕了一个大圈子，李雪莲“分”没离成，男人们理没说清，还把芝麻变成了西瓜。@冯小刚@ @刘震云@ @范冰冰@ @郭涛@ @大鹏董成鹏@  @于和伟@ @张译@ @李宗翰@ @演员赵立新@ @范伟@@道哥刘桦@ @李晨@  < 
时光，你怕吗？我怕!	发布了头条文章：《李晨、张译这帮好家伙，全是演技派！》 时光、欠先生、青山、时光，他们都是好家伙，只是命运让他们站在了不同的阵营，信仰不同的救国理论。电视剧用时而戏谑、时而严肃的情节，卸掉他们的伪装，袒露出他们真实的身份和性情@电视剧好家伙@ < 
只要不负天真，好时光迟早会来的。	昔我往矣，杨柳依依；今我来思，雨雪霏霏。时光是如此奇妙，也许因为漫长的等待，也许因为流逝得太快，才更加显出它的美。今天该说再见了，感谢你们的陪伴，也感恩为《好家伙》付出时间与精力的每一个人，我就不一一@ 大家了。<br/>在坚硬的日子遇见，一颗种子在心里慢慢开出花朵，这已经是最好的结果了。 ...
孩子们，快乐长大！我们愿守护你们的笑容和纯真@陈砺志@:孩子们的脸红润了，看起来状态大好，很开心拥有健康心的你们，可以跟大家一起拥有健康的生活。嗯，我们会一直坚持下去的。现在资助对象已经从西藏扩展到全国，希望可以帮助到更多的有需要的孩子。	 读书、写字、和小伙伴们玩耍……瞧这群天真烂漫的小朋友，大家还记得他们吗？他们就是今年 进藏筛查并送到上海治疗的孩子。孩子们今年6月从阿里来到上海，都受到了很好的照顾，顺利完成了先心病治疗手术，回家后也都恢复得很好，看见他们能正常上学读书，健康地嬉笑玩耍，我 ...
讲到时光亲手杀了小家！也亲手埋葬了自己的爱！蓝瘦！香菇！不，是菇死了！	时光…今天故事讲到哪里了？ 
厉害了，少年	尝矜绝代色 复恃倾城姿@范冰冰@ @范冰冰粉丝团@ @冰冰晨报官博@  
船长，家乡的英雄，我们期待你回来！	【郭川团队：全力实现船长愿望，计划将船开回】10月25日，中国帆船选手郭川在夏威夷海域失联。目前，在相关海域参与搜救的中国货船仍未见郭川的踪迹。同时，郭川团队也已前往夏威夷，将全力实现郭川的愿望，把三体船“中国·青岛号”开回此次航行目的地上海，最终开回郭船长的故乡青岛。不放弃！(央视记 ...
不管对工作还是对朋友，你总是热情满满！加油，东田哥！	我对工作的热情总是有增无减，让我简直着谜！感性创作，理性管理，实在是太有趣啦！@田川_Lany@ @白百何@ @Johnny黄景瑜@ @蔡康永@ @戴军@ @东田造型@ @胡兵@ @范冰冰@ @窦骁@ @高圆圆@ @李艾@ @马艳丽@ @陈数@ @李冰冰@ @霍思燕@ @王海珍@ @倪妮V@ @金星@ @沈傲君@ @任泉@ @苏芒@ @刘力扬JenoLiu@ @田晓龙@ @杨幂@ @赵薇@ @尚雯@ ...
厉害了！我的Elephant Dee！	 跟@大鹏董成鹏@ 组成“大小组合”今日出道，为@冯小刚@ 冯导电影《我不是潘金莲》演唱了同名推广曲作为处女作献给大家！< 
有些事情，不用分什么对，什么错，只是各自站的立场不同，角度和眼光也就不尽相同。还是一句，大家都不易，这就是生活！但是看到同学们笑了！我就开心！这样真好！	范冰冰在此次电影宣传中，接到工作、认真完成工作，对活动进行中的突发状况及各方担心表示充分理解和充分配合。当天活动顺利结束，各方担心的现场秩序问题没有发生。以上实情，作以说明。 
刘杰导演新作明日上映，这是导演挑战的一个新的电影类型，很期待看到导演的这次尝试！明天去看！	 明日即将上映，这部电影集合了几百人近三年的心血，而对我来讲，《捉迷藏》是一次转型，也是一个巨大的挑战。上映在即，我也有些话想和大家说，关于选择，关于纯粹。 
这位英雄机长不仅仅是阻止了一场空难，更是挽救了无数个家庭！赞美机长！	【虹桥机场险撞机事件表彰：处险机长获奖300万】据人民日报，10月11日，上海虹桥机场一架东航A320客机在以时速240公里滑行起飞时，发现有另一架A330横穿跑道。千钧一发时，机长何超临危决断，以最大推力带杆起飞。据测算，两架飞机相撞只差3秒！今天，何超被东航评为先进党员并奖励300万元。网友：赞机 ...
没办法，每年都要给这位哥们刷几次屏！谁让他弄的越来越越好呢？	《二又二分之一次元》2017的早春系列。摄影：谭云飞@wintam0119@ 视频导演：曾博豪@zengbohao@ 化妆：@陈龙119@ 发型：@PaulStudio杰森@ 文字：@Nirokita@     <br/>   <br/>--------【视频请戳】     <  <
今天看了刘雨霖导演的电影《一句顶一万句》，刘震云老师的好故事，值得多看几次的好电影！世界上的事情都经不起推敲，一推敲每一件都藏着委屈！多和你身边的人说说话，每个人都需要倾诉和被理解！	 人来人往的旅途中，背叛不期而至；内心有一场战争，竟然硝烟弥漫！电影《一句顶一万句》终极预告发布，剧情跌宕饱满，台词金句频出，。 @刘震云@ 原著，@刘雨霖YULIN@ 导演，毛孩 @李倩real@ 刘蓓 @范伟@ @齐溪@ @孙茜@ 等待你开启心战！ < 
沈阳的一位观众说的话让我印象特别深：李雪莲气消了，我的气都没消，这帮人跟她纠缠了10年，却没有人关心她究竟是为了什么！沈阳的观众和冰邦们真的很棒！谢谢你们对这部电影的每一点感受！	《我不是潘金莲》在沈阳，我们又得到了很多朋友的观影反馈，感谢大家对李雪莲的喜爱和肯定。有位观众说：笑能治感冒。还有观众说：很多想不到。希望这部片子能带给大家笑声的同时，也能在心里掀起一阵小波澜。[呲牙]服装：@张帅VIP@ 妆发：@张浩然R-studio@  < 
画得真好！可以送给我吗？	有颜，任性@范冰冰粉丝团@ 
恭喜大哥！这56年的路艰辛不易，你的信念和坚持，让Jackie Chan成为全世界熟知的中国符号！实至名归！你一直都是我们的骄傲！????????????	就在刚才，@成龙@ 在美国好莱坞领取了奥斯卡终身成就奖。在台上大哥非常开心，他说“我很自豪做一个中国人”，也感谢了香港，并表示：“梦想成真了！我在电影行业干了56年，拍了超过200部电影，摔断了很多根骨头，终于这个奖是我的了……感谢好莱坞，那些年你们教会我很多事， ...
济南，和看了雪莲的观众朋友们聊到忘了时间！收工啦！	《我不是潘金莲》全国路演开始啦！今天导演@冯小刚@ 携编剧@刘震云@ 主演@范冰冰@ @大鹏董成鹏
这一期的伊周！厚实的、暖融融的冬天！	 伊周 Femina 2016/11/08 : @范冰冰@ by @陈漫ChenMan@ | 范冰冰身穿Louis Vuitton秋冬系列登上新期“伊周”杂志封面，俏皮灵动的少女感～ 
Word刚哥，初心不改，笑里有料！ @冯小刚@	 一个老头儿@冯小刚@ 整天逗人乐，他说他不是成心的，你信么？11月18日看 笑里有料！@范冰冰@ @郭涛@ @大鹏董成鹏@  @于和伟@ @张译@ @李宗翰@ @演员赵立新@ @范伟@ @道哥刘桦@ < 
亲爱的靓颖，美美的新娘子！祝福你们，手牵着手走未来的路，一定要幸福！@张靓颖@:好啊～毕竟“出柜不退”	就这样陪着你砌长城，吃串串儿，一直到老。@张靓颖@  
看了电影，就知道这句话有理！正在热映！	这个出轨女人让人心疼 《一句顶一万句》引议 < 
小刚导演说，这次他当成导演处女作来拍。震云老师说，他深知文学和文字的责任。观众的笑声与喜爱，是我们最期待的！感谢所有，希望更多的朋友11月18号走进电影院，看《我不是潘金莲》！	 观影结束，全场86次笑声21次大笑，字幕出来“范冰冰饰演李雪莲”的时候观众再一次致以掌声。这次冯导@冯小刚@ 又做了一件别人没做过的事儿，感谢所有人的支持和帮助，感谢编剧@刘震云@ 写出来这个故事，感谢主演@范冰冰@ @郭涛@ @大鹏董成鹏@@张嘉译工作室@ @于和伟@ @张译@ @李宗翰@  ...
今晚李雪莲在@花椒直播@ 等你！	 11月15日17:30-18:00，@范冰冰@ 化身“李雪莲”，揭开一段犟到底的故事！明明可以靠颜值，就是要靠演技，太任性！互动直播，锁定花椒，关注ID:59819854。@范冰冰工作室@ 
还有什么想对雪莲说的，我听着呢！	第一期 ！《我不是潘金莲》济南·沈阳站的映后交流会圆满结束！“雪莲冰”特别高兴听到了大家的声音，与观众面对面的沟通。小编君摘取了一些现场观众表达的真实感受，希望在电影上映后能听到更多你们的声音 
为了哪件事情，你愿意花费 10 年时间去找一个答案？	我觉得不值，范冰冰觉得值，你呢？ < 
魔都上海！感谢大家分享！雪莲认真听你们说！	【 路演上海站】路演倒数第二站，魔都上海！大家好才是真的好！ 
上映第二天！雪莲跑着路演，继续听你们说！	 第二期北京·成都，《我不是潘金莲》今天上映啦！回顾一下这两座城市得到提前观影机会的观众们的感受吧。还是希望能听到更多你们的声音，看到更多你们发表的感想给“雪莲”我们现在只！想！听！你！说！ 
一心一亿，我们在努力！????????	 票房破亿，同志们仍需努力！ 
科雷嘉，有魅力，拼实力@范冰冰工作室@:与科雷嘉共成长，2.0升级版合影来袭	高清大图来啦，此处必须有掌声！去年范冰冰小姐的倾情自拍，引得大家纷纷点赞。今天，冰冰自拍技能新升级，与科雷嘉的忘我连拍使得现场气氛好到爆棚！！范冰冰与科雷嘉的组合塑造了颜值巅峰，掀起了本次广州车展的高潮！@范冰冰@@范冰冰工作室@ 
今天是个好日子，李雪莲再送5套礼盒+雪莲签名明信片，给转发这条微博的5位朋友！希望看到这部好电影的你们，也能有好运气！@范冰冰工作室@:今天《我不是潘金莲》正式全国公映，李雪莲也带着她的“冰莲双至”归来啦！欲购速从哦！	 1118《我不是潘金莲》上映啦！速速抢购“双莲冰至限量套票礼盒”影票、纪念周边全拿下~这次我们还特别为冰邦们奉上范小胖@范冰冰@ 为粉丝亲笔签名的《我不是潘金莲》限量明信片哦~还等什么，手慢无~@范冰冰工作室@ 
电影本不易，互帮为重要。	潘金莲致王健林先生的一封信<br/><br/>尊敬的王主席健林：<br/>       小女子金莲，久闻主席丰功伟业，在您的宏观指导下，万达集团全球产业链之大格局、大视野、大胸怀，有目共睹；不仅在商业地产领域成绩斐然，单就影视制作发行行业，除在国内形成垄断，买下好莱坞也指日可待。在此高歌猛进、摧枯拉朽之际，有一小 ...
请继续！	上映第六天，我们始终都在等待和聆听大家的反馈和感受。如果你喜欢雪莲，记得把电影推荐给身边的朋友和家人哦！  
这位大哥，你喊我啥？@李晨@:这位大姐，配合下我们工作好好看电影 哈	 出门要带身份证，别学李雪莲@范冰冰@ ，不然会被警察叔叔@李晨@ 送回家！< 
恭喜@汐冰落@ @Lizy瑜@ @小Qi晓喻@ @宋肥菲@ @枝枝枝千@ ，礼盒送上，希望你们喜欢！雪莲再送5套礼盒+雪莲签名明信片，给转发的5位朋友！@范冰冰@:今天是个好日子，李雪莲送5套礼盒+雪莲签名明信片，给转发这条微博的5位朋友！希望看到这部好电影的你们，也能有好运气！	 1118《我不是潘金莲》上映啦！速速抢购“双莲冰至限量套票礼盒”影票、纪念周边全拿下~这次我们还特别为冰邦们奉上范小胖@范冰冰@ 为粉丝亲笔签名的《我不是潘金莲》限量明信片哦~还等什么，手慢无~@范冰冰工作室@ 
谢谢哥哥们，你们都是我的榜样！李雪莲的故事虽然结束了，但咱们还会在其他故事里再见！	 一个处女座的李雪莲，一个用心的女演员@范冰冰@  ，十二年重逢，不辜负，更惊喜！ 
 想参演《赢天下》吗？最后一天报名了，合适你就来！让我们看到你的梦想，万一实现了呢	椒战天下，海选告捷！截至11月21日，报名人数突破5.3万！海选报名截止时间：11月22日24点！与@范冰冰@ 同台飙戏的机会不要错过！@赢天下官博@ 
今天你去看雪莲了吗？	你们的每一个声音雪莲都在仔细听！还没看过《我不是潘金莲》的朋友们，千万不要错过这部佳片哦！< 
还在南京路演中，这么多场见面会，听到大家说了很多，也看到大家在网上的讨论，谢谢!雪莲继续工作去了	 你的喜欢很重要，是雪莲前进的动力，你的发声也很重要，是对雪莲最好的支持！最后一站路演见面会——南京见 
有心人！@张译@	一夜没睡，以《我不是潘金莲》的路演为例，写的真不咋地，但是写着写着就忽然想念起这些路演的小伙伴们来了@大鹏董成鹏@ @于和伟@ @范冰冰@ ，再次恭喜@冯小刚@ 导演夺得金马最佳导演！【电影路演中，主创人员都要做什么？】 - 回答作者：「@张译」@< 
说真的，导演获奖我心里面也真的是很开心的！输赢乃兵家常事，我们再接再厉！更何况，我们家已经有一匹最好的马了！	谢谢执着于美好的你，透过角色诠释悲喜人生，为大家编织一个又一个如幻似真的梦境。收拾行囊再踏征程，你为演员这份职业而生，你还有更多角色要去完成，除了那颗闪光的贝壳，我还有句话要对你说：无论何时何地，你都是我心中的最佳女主角。 
一马当先！谢谢台湾的观众朋友们喜欢这部电影！太开心呢！！	今天，冯小刚导演和冰冰等《我不是潘金莲》电影主创们，一同出席了第53届金马奖欢迎暨入围酒会。侯孝贤导演为入围者颁发了金马奖入围证书。惊喜的是，《我不是潘金莲》收获了第一座金马奖——观众票选最佳影片！同时北京传来捷报，票房破三！再接再厉！服装：Celine衬衫+阔腿裤 Styling by @闵塔鲨@ Mak ...
哈哈！原来你也是一个离经叛道的小王子！	这是一个 < ，更多的范冰冰在本周六18:00的@湖南卫视新闻当事人@ 里。 
这是什么新玩法？	Mannequin Challenge directed by me 感谢@马楚成@ @梁朝偉@ @唐嫣@ @謝婷婷JenniferTse@ 以及欧洲攻略全剧组 。@范冰冰@ @李晨@ @黄晓明@ @Angelababy@ @赵丽颖@ @大鹏董成鹏@ @包贝尔@ @林更新@ 现在到你们了 期待<br/><br/> ...
这个李雪莲有点不一样！大家记得去看哦！	 娱乐圈规则之一是：女演员不惜扮丑、颠覆自我来挑战角色，就很有可能拿奖。@范冰冰@ 增肥出演《我不是潘金莲》，再次印证了这一点。备受争议的演技被“影后”二字肯定后， 没打算放慢脚步，她说现在的对手是自己。管影后叫“花瓶”？这绝对是赤裸裸的表扬！<br/>Photo by ...
意犹未尽的一次聊天@王江月@:特别巧，上次李晨来节目做客那天，@范冰冰@ 冰冰获得了西班牙圣塞班斯蒂安电影节最佳女演员奖。而今天冰冰这期节目播出时，又赶上李晨的生日。看来冰冰和李晨跟我们节目很有缘份哦祝李晨生日快乐祝冰冰金马好运	@范冰冰@ 与@冯小刚@  十二年后再次合作 ~接戏从不看片酬的范爷为“潘金莲”扮农妇乡下卖煎果实力演绎“冯氏幽默”~本周做客，拒绝一成不变的范爷在里找自己~~http:t.cn/Rf9XW7u 转发评论此微博@ 两位以上好友，就有机会获得范 ...
李雪莲，一个徘徊在有理与无理边缘的女人，十年折腾不过求一个公道。	 人多戏足，你方唱罢我登场，尽显荒诞与现实。一个女人和28个男人，一千个读者心中有一千个哈姆雷特，一千个观众有一千种方式解读李雪莲，那么他们@刘震云@ @范冰冰@ @郭涛@ @大鹏董成鹏@ @于和伟@ @张译@ 又如何解读呢？< 
一分钟讲一个故事，好玩，期待！	故事海报曝光！褪去女王范，她换上廉价的猩红色短袄，戴着醒目的塑料耳环，将俗气的烫发挽在脑后。继农村妇女李雪莲后，@范冰冰@ 再次颠覆形象尝试乡镇女青年，侧身回首，她的眼神充满惶惑、讶异和不屑，这是一个怎样的故事？期待12.13范冰冰的一分钟&gt;&gt;< 
恭喜@诗琪思琪@ @C柠檬冰@ @简简丹丹哟@ @小胖很有范@ @雪雪丢雪雪@ ，雪莲把双莲冰至礼盒送给你们！@范冰冰@:雪莲再送5套礼盒+雪莲签名明信片，给转发的5位朋友！	 1118《我不是潘金莲》上映啦！速速抢购“双莲冰至限量套票礼盒”影票、纪念周边全拿下~这次我们还特别为冰邦们奉上范小胖@范冰冰@ 为粉丝亲笔签名的《我不是潘金莲》限量明信片哦~还等什么，手慢无~@范冰冰工作室@ 
我在@卡地亚@ 的圣诞树下许下了自己的圣诞心愿，你呢？	从巴黎到纽约，圣诞亮灯仪式始终是卡地亚的传统，而今年卡地亚更首次在中国举行大型亮灯仪式。12月1日晚，伴着悠扬欢快的圣诞颂歌，著名演员@范冰冰@ 小姐与卡地亚在上海恒隆广场共同点亮2016冬日浪漫。 < 
瓜子嗑起来 期待成片！	剧照曝光！@范冰冰@ 又一次抛下女神形象，饰演一位乡镇女青年。短短一分钟的戏，拍摄之前，她多次与黎志导演@荔大枝@ 沟通戏中角色的心态，在表演过程中，她也一直努力想把人物复杂，在角色自我斗争的那一刻展现得更加完美。，12.13正片见！< 
来啦！超级快快快递！	今天首映，收到很多朋友消息说特好看。非常非常感谢！！！12月2日！！！一定给大家一份不会失望的超级快递！！ 
转发微博	近日有“范冰冰李晨婚房曝光”相关不实新闻在多家媒体平台转载扩散。经查证，上述不实新闻系某房地产商为售楼蓄意散布，新闻所示房屋与范冰冰小姐、李晨先生均无任何关联。目前，本工作室已委请律师依法处理。 
感谢@卡地亚@，让我领略到高级珠宝的魔法！	11月27日，全新Cartier Magicien高级珠宝展星光熠熠，著名影星@范冰冰@ 小姐摩登现身，以其高雅迷人的气质，演绎出卡地亚全新Cartier Magicien高级珠宝作品的魔幻魅力。 
阿凡达妹妹	都猜出来了吗？终于可以告诉你们，我就是神秘的 ！第一次参加这样的综艺节目，抛开以前所有的身份和标签，唱自己喜欢的歌，真的很开心。不过，虽然揭面了，我还是很希望你们以后也叫我阿凡达妹妹呢[呲牙][呲牙]。 
好玩，有意思！金店小妹的一分钟里发生了什么？12.13见！	赞你我的冰～ 花絮视频来啦！<  这一次努力冰亲自搭配俗气造型，大街上拍戏都没被认出来，接地气儿地当众嗑瓜子儿、拖地，拍摄时手被道具镯子划破也没吭声，导演黎志@荔大枝@ 盛赞看到了一个演员的品格。 ，12.13见！< 
纽约璀璨的夜晚！	纽约时间12月7日晚，De Beers戴比尔斯美国纽约麦迪逊大道旗舰店正式揭幕，新店占地约200平方米，位于曼哈顿上东区的黄金地段麦迪逊大道716号。此次开幕庆典邀请了凯特·玛拉、格蕾塔·葛韦格等几位国际影视圈的杰出女性亲临现场。令人惊喜的是@范冰冰@ 特地从北京飞抵纽约担任戴比尔斯纽约新店的启幕大使 ...
感谢@微公益@ @新浪公益@ 对“爱里的心”的鼓励！爱一路前行@爱里的心@:恭喜冰冰获奖，同时 荣获2016年度微博十大最具影响力公益项目奖，感谢@新浪公益@ @微公益@ 感谢冰冰的善心和坚持，在救治先心病患儿的道路上，我们会一路前行	@范冰冰@ 始终保持着一颗善良的心，她发起的“爱里的心”慈善项目已进入第7年，以‘救一个是一个’这样实际的理念，一步步踏实走来，给241个先心病患儿带去“心”的希望。不忘初心，一路前行。霸道又温暖的范爷获得“2016年度微博十大最具公益影响力名人”，实至名归。 ...
哎！我说（京腔）羊肉泡馍可以有吧！糖蒜也来着！粉丝要双份！再加点辣子！天哪！光想想已经在不断咽口水了！	筋而不硬、味醇汤鲜、油香浓郁、辣味悠长、咸酸适口，陕西好食在“零贰玖”都能找到。1212，要爱零贰玖！北京朝阳门悠唐广场地下一层 
噢！请继续撩就对了！	@李晨@ 登上《嘉人》1月刊，封面大片新鲜出炉！好人李晨在史诗电视剧《军师联盟》中演了一个“不那么好”的家伙——嫉妒胞弟才华要求其七步成诗的曹丕，他说希望将“人物最丰盈的瞬间状态‘哐当’放到观众面前”，不纠结好或坏。筹备着作为导演的第一部电影，范冰冰公开认定的“最后一个男朋 ...
噢！好！我们空中见！	全新篇章，，走在不平凡的路上，那些被封印的梦，咱们空中见。@adidasBasketball@ 
自拍真的辣么被嫌弃吗？	你们要的他拍???? < 
哎！	在雾霾严重的北京居然偶遇了范冰冰，还合了影，好开心 
认真生活，认真演戏	 黎志@荔大枝@ 执导，《迷》正片→< @范冰冰@ 坦言碰到好导演，可以为自己打开一扇窗户，让灵感洒到身上。拿到国际影后，她只当是肯定和礼物，继续认真生活，认真演戏。 
哈哈哈，真可爱呀！	台湾一位网友记录下了爷爷奶奶可爱的互动瞬间，太有爱了< 
分享一只不好好穿衣服星人！	@我们的街拍时刻@ 【圣诞特别企划】@范冰冰@ 的街拍look. 千呼万唤始出来，欢迎全民女神 来我们的街拍时刻。  清新可爱的印花图案可复古可文艺，丝质材料绝对是表现柔美和温婉气质的必备单品，搭配白色休闲鞋绝对的混搭新高度，无敌好看，吸睛十足。印花装饰睡衣套装：Dolce&amp;Gabbana ...
贺岁档！祝票房大卖！	 大家笑才是真的笑，我们的目标是让全中国都笑起来！今天， 哇哈哈哈哈上映啦~五情圣组团搞事，三女神“要命”登场，让你笑出新高度，乐出新姿势！@摄影师宋晓飞@@董旭的微博@@肖央@@素描闫妮@@小沈阳@@演员乔杉@@演员艾伦Allen@@代乐乐@@演员常远@@ClaraLee克拉拉@ 
习惯睡觉前看看微博，然后发现自己睡的越来越晚，怎么破？	想知道@范冰冰@ 在过去这一年里，自己最难忘的一次上热搜的经历是什么嘛？戳视频，看冰冰讲述，更多有料盘点，点击< @范冰冰工作室@ @范冰冰粉丝团@ < . 
可能是因为我会看到吧！哈哈哈！不错哟！	抱歉，由于作者设置，你暂时没有这条微博的查看权限哦。查看帮助：网页链接
大年初一，想看！@苏芒@:新的一年，最想看的电影！2017最该有的态度！《乘风破浪》，@韩寒@ 大年初一见！	《乘风破浪》，2017年1月28日，大年初一见。定档海报在下面，定档预告片点右边链接。新的一年， <  <
渡人渡己	其實天下之大，又何止南北。一味求全，等于固步自封。在你眼中这只是一部電影，对我来讲是一个世界。所谓大成若缺，有缺憾才能有进步。摆渡人，渡人渡己---<br/>                    <br/>                             我喜欢<br/><br/>圣诞快乐。 
假装自己是一棵圣诞树！平安夜快乐????圣诞节快乐！????	圣诞节来了！准备好怎样庆祝了吗？我们提前在街头捕捉到了一只圣诞冰，送给节日中的你！造型：@AKAstudio@ 摄影：@张浩然R-studio@ @R-STUDIO然摄影@ 
哇！头宝正式出道了！在圣诞节前夕！纪念！	明星大头穿2016高级圣诞定制礼服荣登@闻闻窝宠物管家@ CQ封面，这个范儿是不是不亚于麻麻@范冰冰@ 
亲爱的心如，辛苦了！祝福小公主健康、快乐、无忧无虑地长大！ @林心如工作室@:世界美好，欢迎光临，我们的小公举～	❤❤❤ 
我不是马里奥，我是蜘蛛侠！ <	2017年第一组美图登场！这次范小瘦变身“超级马里奥”，萌萌帅帅blingbling滴，你们可还喜欢？造型：@AKAstudio@ 摄影：@张浩然R-studio@ @R-STUDIO然摄影@ 
这一期的《VOGUE》，向表演致敬，向美致敬！ @angelica张宇@:欣赏不断努力挑战自己、丰富实力的@范冰冰@ ????	在很多人的印象中，@范冰冰@ 一直都是“美貌、霸气”的代名词，但在最近上映的电影中，冰冰以颠覆性的形象和让人眼前一亮的演技再次证明了自己，也促使她再次成为我们的封面明星，登上 ，在摄影大师Patrick Demarchelier的镜头前展现自己的魅力。<br/>造型：Daniela Paudice 
我的2016! 时光飞逝！我们又一年！@闵塔鲨@ @胡議尹@@张浩然R-studio@@七明多@ @卜柯文@ @范冰冰工作室@:谢谢小伙伴辛苦整理！2017年，她还将马不停蹄地继续努力，呈现更好的更美的自己！	 【2016时尚造型大盘点】 @范冰冰@ 今年到底有多忙？不完全统计的各大活动造型就有90个，平均每4天就要参加一个活动，这一年范爷不仅跑遍了全国各大城市，更是跑到日本、美国、法国、新西兰、西班牙等国家为电影和代言的品牌宣传站台，再次拿下国际影后的冰冰让人无比期待她的2017！ ...
速来！	每次看见范冰冰发的年终奖，都好想去她的工作室上班，这么大方的老板哪里找？？？ 
2016拜拜，2017请多指教！祝大家元旦快乐！	2016年，冰冰参演的4部电影亮相大银幕，凭《我不是潘金莲》荣获第64届圣塞巴斯蒂安国际电影节影后，成为中国第三位国际双A影后，登上13本刊物的封面，两次出席巴黎时装周，“爱里的心”进入第七个年头，共救治了241名先心病患儿，全年累计飞行110多次，忙碌依然占据着她大部分生活，所有成绩的背后都是 ...
2017，我们来了！	2017，天天开心事事顺利范小瘦。 
好的，不见不散！新年快乐！	『2016年末寄语』林花谢了春红，弹指间，太匆匆，今年是范冰冰粉丝团成立十周年，回首来时路，四年博客，六年微博，岁月不曾虚度，载载光阴不负，感谢冰邦们这十年对粉丝团的陪伴与支持，更感谢冥冥之中的缘分，让你我于千万人之中，爱上了同一人，哪怕这样的爱在外人看来，不被理解、赞同，但那又如何 ...
哈哈哈！制片人，你们所有的努力总有人会看得见！@李晨@	豆瓣給「好家伙」的評分⋯????????????挺內行的[ok] < 
真的好听！@林俊杰@	【林俊杰改编抒情摇滚版《崇拜》】行走的林CD翻唱什么都能这么好听~梁静茹的《崇拜》被JJ改编出了不同的味道！好棒的Live，太好听了！< 
我妹儿！	小白妹妹有一个特长，就是吐舌头卖萌！ 
鹏鹏儿时的梦想是组一只自己的乐队，那时候你看起来白白胖胖的！哈，9月30号，去看你离梦想又近一步！????????	35岁的生日愿望，是踏实地完成自己导演的第二部电影，@缝纫机乐队@ 。海报上是15岁的我，少年，我们9月30号见！ 
我们在北京台春晚陪大家过年！	2017年北京台春晚打开的正确方式↓↓↓ @范冰冰@ @李晨@ 和你一起过大年~@北京电视台@ @北京卫视@ 甜蜜初一见~  < . 
感谢每一份青睐，不负每一寸光阴！@angelica张宇@	这一两年的@范冰冰@ 整个人的气场变得柔软了许多，身上甚至还有一种无来由的喜气洋洋，与恋爱有关，却又不完全因为爱情。过去的十几年，她一直都在拧着劲儿证明自己，而今那心气儿仍在，但因为周边的世界变得善意，她身上的坚硬铠甲也变回了柔滑丝绒 <br/>摄影：Patrick Demarchelier  造 ...
其实我爸今年才61！哈哈哈！	北京电视台春晚，范冰冰身穿蓝色纱裙仙气十足与其父范涛同场亮相，感叹66岁还能保养的如此之好，精气神也不错，羡慕啊。 
欢迎@郭靖Red@ ！这个温暖的大家庭又注入了新鲜的血液！这是一个有梦想，也愿意拼了命逐梦的男孩儿，演员这条路很辛苦，我们愿意陪你跨过每一道坎儿，希望你有信心和恒心，就像金庸先生武侠小说里的“郭靖”一样，永远不断向前！加油！	欢迎新同学——@郭靖Red@ 签约范冰冰工作室！他拥有四分之一荷兰血统，轮廓分明的线条和深邃有神的眼睛，令人印象深刻。他就读于韩国建国大学，曾是M.Pire组合中唯一的中国成员，精通韩语、英语，唱跳俱佳的同时，对表演也有着极高的热情。谦逊有礼，幽默阳光又积极好学的郭靖，在电视剧《赢天下》中也 ...
祝福Baby和明哥！欢迎小海绵，快快乐乐健康成长！ @angelababy@:	小海绵降临母子平安???? 
大年初一来伏妖！Word凡，来碗鸡汤！ @Mr_凡先生@:“有过痛苦，方知众生痛苦...”鸡汤凡上线！	周星驰、徐克联手打造的电影《》“众生”版预告曝光！你们期待的“正经”预告来了~你们期盼的“特效”来了两分钟的预告信息量很大！“这个世界不是朋友就是敌人。”猜不透的周星驰徐克，你伏（服）不伏？ < . 
大头居然开口说话了，晚饭加饺子！祝大家春节快乐！各位铲屎官，新年“集翔”如意哦@马特Matt@:艾玛，大头还是很有主播范儿滴@范冰冰@	麻麻@范冰冰@ 派大头宝宝来送新年祝福咯！????祝各位铲屎官在新的一年里，大吉大利！身体棒棒！财运汪汪汪[红包飞]毕竟只有酱紫才能带我们看世界，吃美味~当然，你们也要努力铲屎，毕竟“集翔”才能如意嘛年三十了！快快牵着闻闻的小爪爪，一起迎接这个可爱的幸福年嘞！  ...
到外太空蹦跶了一圈，回到地球好亲切！	 我们以一段经典电影为背景，为@范冰冰@ 安排了一次穿越时空的冒险之旅。在这段旅程里，冰冰不仅去了月球，还寻到了宝藏，遇到了奇异的朋友……这段诙谐、有趣的 也将作为“入时：康泰纳仕百年摄影展”的一部分，在@尤伦斯UCCA@ 播出，千万不要错过哦~ < 
你老爸颜值也好高啊！你怎么看着像动画片里的小孩爸爸妈妈永远是每个人心中最帅最美的人，祝福天下所有的父母！	听了冰冰姐和爸爸一起唱的,心里特别感动，看到冰姐帅气的爸爸，我也想起了自己的老爸。在外这么久，想家的情绪突然又涌了上来，以前老爸是家里的顶梁柱，但以后我会帮老爸撑起这一片天。快过年了，提前祝所有的爸爸妈妈身体健康，新年快乐。 
小时候，在台下看着爸爸唱歌，常常想，有没有一天可以和他一起唱呢。今天，我和爸爸唱这首歌，一起为发声。谢谢@作曲董冬冬@ 陈曦@cicidodo@ 用心的创作，用音乐延续温暖和感动。“爱里的心”迈入第八个年头，谢谢每一位参与其中的人！	 8年！我们有主题歌啦！由@作曲董冬冬@ 作曲、陈曦@cicidodo@ 填词。冰冰与父亲范涛共同献唱，歌曲表达了对西藏阿里地区先天性心脏病儿童的关爱与祝福，传递无限正能量，更是温暖人心< 
元宵节快乐！祝朋友们在元宵节团团圆圆、和和美美！把刚做好的汤圆送给你们哦！	 第六期，元宵节特制来啦！@范冰冰@ 接受了我们“包汤圆同时快问快答”的挑战。这可是冰冰第一次动手包汤圆，还回答了“处女座靠什么赢天下”这个替所有处女座宝宝们撑腰的问题！2月14日上午11点，范冰冰封面与大家不见不散！@范冰冰工作室@ <br/>监制：@卢昊大人@  策划、执行：Bonni ...
在片场祝大家开工大吉！得了节后上班恐惧症的举手????	这个小子有点儿帅！放一组高清帅气冰祝大家开工大吉！造型：@AKAstudio@ 摄影：@张浩然R-studio@ @R-STUDIO然摄影@ 
大姐、三妹，饺子准备好了！等下一起看春晚！巴清祝大家鸡年吉祥，天天都有好运气，时时都有好心情！	巴家三姐妹来拜（mai)年(meng)，祝大家开年赢天下～  
好听！循环ing！	  《默》……  < 
把我夸的呀！爱我们专业的小伙伴们！@刘阅微@ @卢昊大人@	不是每个人都能成为@范冰冰@ ，甚至她的成功并不具有参考性：相同经历下能够像她一样在“枪弹”中生存下来的人少之又少。可以很酷，也可以极致温柔的她，不可模仿，也无法超越。@刘阅微@ <br/> 线上购买：<<br/>监制：@卢昊大人@  摄影：@布法罗的树孙郡@ <br/>形象：@Yanneyy@  编辑： ...
哎哟！	@范冰冰@@李晨@  @范冰冰工作室@@小黄少@ @刘小腕儿@  今天又是大夜班,礼物直接送到拍摄现场，我晨哥的用心程度真是不一般的，要是情人节都这样，哪个女生不想天天过？ 
紧接着音乐响起来，啊⋯啊⋯，西湖美景三月天呐⋯	卧槽？！哈哈哈哈笑岔气！特么还以为白素贞来了……< 
想看！	 终极预告暖心来袭啦。还记得《忠犬八公的故事》电影吗？催人泪下，从头哭到尾，绝对感染力十足。还是这个导演拉斯·霍尔斯道姆，全新执导的萌宠治愈系 一条狗演绎四生四世人狗情缘，温馨惬意，诠释着一人一狗一个家的美好夙愿电影于3月3日上映！ 微博专享价抢 ...
坚持与实际是我们最重要的信念，谢谢大家的鼓励和帮助， 努力 @爱里的心@:冰冰入榜，感谢大家对我们的关注与肯定， 定不会辜负大家的信任，努力播撒更多爱和希望	2016中国慈善名人榜揭晓，@西藏昌都人韩红@ 第一，@陈坤@ @范冰冰@ @羽泉@ @i周迅@ 李亚鹏@一号立井@ 以及@黄晓明@ @angelababy@  @佟大为@ @关小悦joy@  @徐峥@ @陶虹@ 几对夫妻档名列前茅。@TFBOYS@  张艺兴@努力努力再努力x@ @鹿晗@ @胡歌@ @蒋欣@ @刘涛tamia@  @林志玲@ 也上榜。人美心善< 
娃娃姐，咱们互相温暖！养足精神加油拍！	在下雪的晚上，冰冰特地送來了滿滿一箱又紅又香甜甜的草莓，甜了我的咀巴暖了我的心，謝謝妳，冰冰！❤[愛你]@范冰冰@ 
 @范冰冰工作室@:我们的雪莲！	 外网路透 | 第64届圣塞巴斯蒂安电影节官网PO上群像图影，影后范冰冰在群像中清晰可见。2016年@范冰冰@ 凭《我不是潘金莲》荣获第64届圣塞巴斯蒂安国际电影节影后，成为中国第三位国际双A影后。 
加油吧，少年！	春天到了，和你们说一个秘密。@歐陽娜娜Nana@  
发在超话里也能被你瞧见？别分心了！好好导戏！李导演！ @李晨@:敬业爱岗好同志，活血化淤要保重，横批心痛我冰。	为什么拍场戏就像跟人打了一架！ 
睡觉前看了一段视频，振奋人心，也感同身受！晚安！	哈佛女生现场演讲：关于国家的稳定与每个人所追求的安全感，少年强则中国强！这个时候看这个视频，更加动容！< 
愿为更多的孩子带去希望！ @陈砺志@: 面向全国资助的第四例孩子！希望传播给更多有需要的人，记住先心病孩子可以求助爱里的心！	 全国范围资助的第四例罗西雨，出生不久就查出患有先心病，3岁时又被诊断出患有6种严重病症，唯一的治疗方法是手术，但孩子家庭贫困没办法治病，眼看病情严重到危及生命，爱里的心及时伸出援手。2017年爱里的心再出发，为小西雨送去“心”希望 < 
我骄傲！	又一位中国设计师走向世界，范冰冰御用造型师@卜柯文@ 给水果姐的新单曲MV《Chained to The Rhythm》量身定制了一套服装，这是她第一次在MV中采用中国设计师的衣服，大家觉着如何～ 
啊！这就是我想要的生活！	快如闪电的叫饭桶，慢还挑食的才叫吃货！ < . 
期待！	期待全新的《中国好声音》< 
谢谢我最爱的冰邦们！ @范冰冰工作室@:莫问前程吉凶，但求落幕无悔。这一路上，坎坷虽必不可少，但爱和坚持却可以化解一切。	2010年，@范冰冰@ 凭借电影《观音山》斩获第23届“东京国际电影节”之“最佳女主角”奖，时隔6年，范冰冰再次凭借电影《我不是潘金莲》拿下64届“圣塞巴斯蒂安电影节”之“最佳女主角”奖和第11届“亚洲电影大奖”之“最佳女主角”奖，岁月不曾虚度，载载光阴不负，时间也许是最好的证明，见证了 ...
这群人里，有我敬爱的师长，有我尊重的榜样，有贴心的朋友，还有最勤奋的新鲜面孔……感谢每位演员的付出，也感激我们能够相聚于此，“天下”因你们而“赢”！	一朝天下一朝赢，且看秦家繁盛景。赢天下，赢人心！@范冰冰@ @高云翔@ @严屹宽@ @马苏@ @张国立@ @郭品超Dylan@  @潘迎紫娃娃@  @姜宏波@ @謝依霖HOLD住姐@ @任山@ @林鹏Peng@ @萧浩冉@ @小冉君@ @郭靖Red@ @鄭雅文Veronique@ @朱嘉琦z@ @刘晓虎@ @袁晓旭@ 
巴清成长路上不可或缺的你！相扶相持，斗智斗勇，亦师亦兄，亦敌亦友。“天涯四美”宽哥的迷妹们在哪里，一起来转发呀，让我看到你们摇摆的双手！@严屹宽@  	如玉俊朗，如水柔韧，缘起丹砂笑对，回首半生情深。你一步，我一行，问天下凭谁！@严屹宽@ @范冰冰@  
女子具才德，亦可赢天下。我们剧中见！小伙伴们转起来哈，转发量最高的，送你一只嬴政@高云翔@ 可好？我是巴清，绝对说话算话！不信你试试？	 山河之阔，家国之大，有匪君子，所谓伊人。何以为喜，何以为忧，制丹砂，济世人，筑宫墙，赢天下！@范冰冰@ @高云翔@   
孤独不是永远的，在一起才是永远的！8年，想念南风，谢谢冰邦！@李玉@	『剪影流光』山有木兮，木有枝，心悦君兮，君不知，生命如烟火，短暂如昙花，幸与你共度年华。<br/>by：天才木木圆滚滚<br/>< 
今日上映！大头哥哥、心如加油！	分享图片 
哈哈哈哈	有一个超级黏人的男朋友，是种什么体验？< 
每滴汗水，待未来的丰收！为怀揣梦想的他们加油！ @乐华娱乐杜华@:为每个有梦想的孩子加油！	“ 第二单曲  正式跟大家见面啦！一起为梦想加油，将梦想实现！”< (使用录制,免流量看热门短视频!) 
帅小伙长大了要努力工作，幸福生活，做个有担当的男人希望孩子们都健康快乐，谢谢你们带给我的感动和动力 @陈砺志@:棒棒哒！六月初 第八次进藏，我们已经在锻炼体能，筹建医疗小组啦！	 照片中的大男孩叫边巴，是我们2013年入藏筛查救治的先心病患儿，当时的他十分瘦弱，由于患有先心病，他无法像正常的孩子一样在学校上体育课，胸闷气短无法跑步。送他到上海进行开胸手术后，边巴现在已经完全康复，并在阿里地区卫生局当了一名保安。边巴不仅拥有了健康强壮的身体，稳定的工 ...
我的吃货模式！对！吃独食！ @范冰冰工作室@:夏天快到了！别吃啦！	“她的一切经得起岁月的推敲”<br/><br/>视频剪自日本三得利乌龙茶的一组广告。中国女演员范冰冰素颜出镜，由日本摄影大师上田义彦拍摄其吃东西喝茶的样子。<br/>作品清新淡雅，平静朴素。完美的光线色调构图都让人无法分辨是商业广告还是写真大片。<br/><br/> and <br/>@范冰冰@ <br/>PS: 我觉得这是拍的最开心 ...
第八年！新一轮进藏筛查已进入准备阶段，老地方新开始！我们继续努力！  @范冰冰工作室@:两位 发起人在榜，感谢大家对公益和@爱里的心@ 的关注与支持，动力百分百	星光公益榜2017年3月TOP10正式发布！3月冠军是@范冰冰@ ！范冰冰一直心系她与@陈砺志@ 共同发起的公益项目，不断通过微博和网友分享项目最新成果。六月初爱里的心项目将第八次进藏，祝福更多的孩子获得救治，并因此改变人生近期，另一明星公益项目也启动了第 ...
青春是你我的芳华。@冯小刚@:萝卜白菜，各有所爱。	青春不是年华，是心境，要用韶华尽展逐梦风姿，用生命书写不朽热烈。青春不是忘却，是你我芳华，要在力量中绚烂绽放，在炽热中镌刻永恒。而我们恰青春，我们正芳华。@冯小刚@ @黄轩的微博@ @苗苗-vivi@ @钟楚曦@ @杨采钰Ora@ @李晓峰cherry@ @不停锻炼的王天辰@ @王可如Nina@  ...
我是绝不会撒手的，那个谁？为啥我的偶像包袱最大？哈哈哈！@马苏@ @彭小苒@ @赢天下官博@	姐妹们，背好我们的偶像大包袱！@范冰冰@ @彭小苒@ 
感觉自己正能量爆棚，来吧！48小时往返纽约＋上海＋横店！就是这样的节奏！请继续！	小胖子出席了在纽约举办的TIME 100晚宴。入选《TIME》全球影响力百人榜的唯一亚洲女演员。因为要倒出五月的时间陪胖去戛纳，所以在家拼命工作。小胖子们连续飞行28个小时只为这短暂的七个小时，还要五个小时汽车回横店继续奋战，都是钢铁战士啊！论体力！我只服你！@范冰冰@ 
跟很多喜欢的人一起看电影！美妙了！	第70届戛纳电影节主竞赛单元主席Pedro Almodovar，主竞赛单元评委Maren Ade, Jessica Chastain,Fan Bingbing, ParkChan-Wook,  Agnès Jaoui, Will Smith, Paolo Sorrentino, Gabriel Yared。冰冰将任本届戛纳电影节主竞赛单元评委，开启70周年的戛纳之旅。 
关注电影，关注《青年电影手册》！ @电影人程青松@:五月是属于青春的，也是属于电影的，相约《青春电影手册》公众号dianyingshouce66 的系列报道，相约戛纳！@范冰冰@	“《青年电影手册》第七辑集结18位青春影评人<br/>描述影史上最动人的100部青春片<br/>程青松主编<br/>徐静蕾题写书名<br/>导演王小帅 岩井俊二 封面领衔<br/>90后演员代表 春夏 董子健 青春对话<br/>贾樟柯张译王宝强等人诚意推...”我的秒拍作品，一起来看~<（使用录制,免流量看热门短视频!） 
真高兴！又听到一个好消息 @范冰冰工作室@: 漂亮的小姑娘，愿你的笑容永远这么灿烂、温暖	 全国范围资助的第五例是来自江苏的7岁女孩周淼。曾因家庭贫困无法治疗先心病的她已经在爱里的心的帮助下成功手术，现在周淼开心地出院回家了，圆了“心”梦的她笑容格外灿烂。  将继续传递爱，为更多先心病孩子带去健康 < 
两年多了，时间好快！还想去看。	<[星星][星星][星星][星星][半星]，  科幻大片《银河护卫队2》全新中文预告片！哈哈，终于要上了！！银河护卫队在本集中穿越宇宙，继续外太空的史诗冒险之旅……明日上映！！！<<br/><br/>时隔两年多，漫威电影宇宙最逗比的五人组——不，是三人一树一熊组— ...
娜，愿快乐与幸福永远陪伴你！生日快乐！????????	金牛娜小妞，生日快乐???????????????????? 
酒窝！可爱哟！	横店一日游偶遇一位仙女姐姐，酒窝一皱眉，发现事情不简单 
康永哥和小S！这很康熙！5月27号《吃吃的爱》，我一定买票支持！@蔡康永@ @小S@	你们一定是嫉妒我的美貌，才会这样对我！我“恨”你们！！<br/>< 
乘风扬翅，飞越云海！	风起云涌之处，雄哉！壮哉！儿时的梦想照进现实，我虽不是军人，但军人的血性不灭。  @吕建民@ 
小姐姐在这里！????????	@范冰冰@ 我的小姐姐有点帅哦～???? photo by me ????????‍♂️ 
欢乐颂来了！涛儿的歌好听！你真有能唱歌的天份！加油！收视长虹！ @刘涛tamia@:属于安迪的????	《 》安迪人物主题曲《家的滋味》独家上线网易云音乐啦！这首由剧中饰演安迪的@刘涛tamia@ 倾情献声，著名音乐人@作曲董冬冬@ 、陈曦@cicidodo@ 度身打造的歌曲，将欢乐颂中缺乏安全感、对家庭极度渴望的安迪呈现给大家。试听&gt;&gt;< 
哭了	大黑牛@李晨@ 堪称伐木累里的力量担当，但却是铁汉也有柔情，在今晚21:10 ，晨哥不知遭遇到怎样的情况，热泪挂满眼框？< 
我们也相信，一切都在变好！	纪念汶川地震9周年：无论什么时候，比思念和悲伤更要紧的，是继续生命的意义，珍惜拥有的每一秒 ，没有什么比生命更美好。我们也相信，一切都在变好！ 
好孩纸！ @李晨@:比心点赞，好孩子	【金毛犬在海边捡5年垃圾，被称为最萌环卫工】它叫老虎，是一只金毛犬。5年来，它在厦门曾厝垵海边一趟趟来回，废塑料、烂拖鞋……凡是被它看到的垃圾都会一一捡上岸。老虎今年8岁，相当于人的56岁。它视力越来越差，很近的垃圾也要帮忙定位，但它还在坚持。真正的环保卫士！< 
同样厉害的科科！加油！	同样的城市，不同的赛场！????️ 
一屋两人三餐四季，我们的纪念日！	初夏的北京清风拂面，凉爽的刚刚好，想起那天戛纳的海边，我们走在阳光里肩并着肩。四季让人喜爱，全因它一直循环，缓慢但到来。时光流转，唯爱始终，谢谢你的到来。在一屋两人三餐四季里，继续快乐前行。 
循环播放S的歌，看着电影里的画面，感动！	我有一个想告诉你的故事，关於活着就别让自己後悔的故事，我把这故事拍成了【吃吃的爱】，而且找了个我心目中怎样都有戏的女生来演⋯⋯@小S@   < 
支持威廉弟弟的第一部电影！ @王中磊@:六月2号，去看电影《美好的意外》一定会有“美好的收获”，也请支持弟弟的第一部电影！	如果人生不是现场直播，如果有机会彩排另一种生活，亲情和爱情在你心中的模样会不会变得有所不同，希望孤单不再是你的习惯，让这段成为一场最暖心的惊喜。@桂纶镁@ @演员王景春@ @歐陽娜娜Nana@  @陈坤@ 6月2日，反转奇缘。< 
感恩，感谢！我要开始看电影了！@卜柯文@ @闵塔鲨@ @胡議尹@ @章元一@	第70届 开幕式红毯，冰冰与其他评审团成员一同亮相。 
哈哈，我感觉我整个人都方了！	法兰克福转机 
第八次筛查，这些日子，每天都在紧张地等着你们传来最新的消息，祝福这73个孩子都能顺利完成手术，重获健康！感谢每一个为爱里的心付出的人，孩子们小小的心脏因你们而强大！	 西藏阿里儿童先天性心脏病第八次筛查工作结束。共筛查4685人，确诊73例。孩子们将会尽快被安排至上海和北京接受治疗。有难受，有感动，有高兴，有遗憾，更多的是尽力，2018我们会再见！感谢一路照顾我们的西藏阿里地区红十字会格桑珠杰和白玛格桑，还有每日辛苦为我们和孩子奔驰的司机 ...
品超，生日快乐！40度高温还在拍，辛苦了！	今年的生日真的讓我好感動！謝謝我的家人們，謝謝劇組 當然還要謝謝最美的冰冰@范冰冰@ 給了我一個難忘的生日！ 
生无可恋吗？	ins上一对生无可恋的喵兄妹。。。我就静静的看着不说话 （ins：ojarinn） < 
时间过得真快，一转眼她们都是大姑娘了！记得当时她们有点害羞地唱歌给我们听，特别感动！也祝福3岁弟弟可以尽快康复！	 筛查回访普兰县城和热帮乡时，复查两个小姑娘，一个是次桑拉姆，一个是达瓦拉姆，巧合的是她们当时是同一批2015年在北京手术的孩子，也因为此成为好朋友。冰冰当时去医院看望她们，给她们带了礼物，孩子们还唱起藏语儿歌给她听。看到她们健康成长，万分高兴。而经过达瓦拉姆的事情，她 ...
期待早日听到孩子们顺利康复的消息！	 第一站筛查工作已完成，共筛查改则县第一、第二小学154人、县幼儿园282人、学校自检疑似学生6人及周边乡民孩子68人，共510人，回访5人，确诊5例。在整个行程工作结束后，会尽快安排孩子们前往北京、上海医院治疗 
六一快乐！	儿童节到！下面，请欣赏由小小冰同学带来的乐器演奏！< 
一次尽情从形式和内容上尝试接近黑色电影的美学探索。向黑色电影经典致敬！@angelica张宇@: 电影周来了。第一天：@范冰冰@ @高云翔@ 向黑色电影(film noir)经典致敬。	@范冰冰@ 、@高云翔@ 主演《无需敲门》，向黑色电影（Film Noir）致敬。正如导演 @时晓凡_QUENTIN_SHIH@ 所说，影片讲述了一个女人与电影之间的爱与挣扎、与神秘侦探的纠葛，这是一段关于一位出色的演员在电影戏中戏外面对电影诱惑的艺术旅程。<<br/><br/>范冰冰珠宝提供：DE BEERS 
好家伙，白玉兰奖的最大奖项“最佳中国电视剧”被你给拿到了！是不是觉得很开心，所有的不容易此时都觉得值了！为你高兴，也同时要谢谢@唐德影视@ ，@北京电视台@ ，@搜狐视频@ ，是这样一帮好朋友在，最困难的時候有你们的帮助，才让这样一部好戏重出江湖！感恩！感谢！	去年，很多人问我对于《好家伙》被尘封4年后的播出心情如何，我说“一切都是最好的安排”。如今，《好家伙》得到了大家的认可和喜爱，我和伙伴们心里的“种子”不但落了地，更开出了花。兰晓龙、黄伟、简川訸、张译，还有奋战过的每一位都是好家伙。 
一张张照片，有感动，有欣慰，有心疼，更多的是温暖，期待孩子们的康复 @陈砺志@:一眼回到十天前，一切历历在目，但是所有的苦和困难，看到孩子们的笑脸想到她们手术后就可以恢复健康，就都值得了！	感谢@老缺先生@ 的相机记录，这一篇全是图片，有我们走过的路，见过的人，做过的事，吃过的苦。每一次从阿里回来，都需要很久才能适应，有时候感觉自己还颠在土路上，还瘫在缺氧中，还在赶着野狗找厕所，还在吃风干的牦牛肉，还在组织排队的孩子和家长，还在担忧打针吸氧的队友。还好，有 ...
希望大家通过这本书都能找到最适合自己的风格！祝阅微姐新书大卖！	风格不是数学题，套不了公式，它是在通晓了时装的前世今生，不再剑拔弩张气喘吁吁追赶潮流后，慢慢形成。风格是不停尝试，是学会放弃，是阅历的积累。是一次又一次的迷路，终于找到终点。希望这本《风格何以永存》成为你随身的地图，看到所有的方向，看到自己的方向。当当购买地址< 
感谢！在同事们的安排下，孩子们已经准备前往上海和北京接受治疗，祝福！	星光公益榜（2017.06.03-2017.06.09）一周TOP10发布啦！本周冠军是@范冰冰@ ！由她参与发起的 西藏阿里儿童先天性心脏病第八次筛查工作结束。此次共筛查4685人，确诊73例。孩子们将会尽快被安排至上海和北京接受治疗，祝福！这一周多位明星参与倡导环保活动，@李晨@ @宋佳@ ...
嬴政和巴清重返上世纪中期，推开黑白影像的大门，光影间的慌张、不安、有趣、神秘。向经典致敬！@高云翔@	狭窄的空间里忽明忽暗，她的眼里写满不安，一举一动都是忐忑慌张。@范冰冰@ 用细腻的表演演绎 《无需敲门》，期待6月16日  < 
谢女士，你说你是不是觉得很幸糊！	谢女士有点儿太幸福了吧???? 
最好的反击，不是冤冤相报，不是你骂我一句我打你一拳，而是，闷头变得更好，变成对方垫着脚都笑话不到的人。[加油][加油]	 就像刚爬山的时候，山下围观的人骂你笑你，觉得你根本没戏，当你爬到一定的高度，那些骂声就听不见了，只能听见树梢的鸟鸣声，山谷的流水声，竹林间的风声……<br/> <br/>最好的反击，不是冤冤相报，不是你骂我一句我打你一拳，而是，闷头变得更好，变成对方垫着脚都笑话不到的人。<br/> <br/>越受伤，越要活 ...
燃爆了的撕名牌！好精彩！但也好累吧！你们都好棒！嗨！旋转牛！你玩儿嗨了吧！	 以一挡三，这个大黑牛@李晨@ 不一般！旋转跳跃，以最快的速度躲避对手，保护自己的名牌，占据有利位置，一个“快准猛”，迅速撕掉对手名牌！撕名牌技巧，你get了吗？ < 
这是跨世纪的20年，五星红旗飘扬的时刻永远会被我们铭记！为祖国骄傲！????????	香港回归祖国的那一年你多大？还记得那个激动人心的时刻吗？今天，，一起转发传递，祝福香港，祝福祖国！< 
上天不会辜负每一个努力的人，所以，加油吧！我们！ @范冰冰工作室@:2017年奥斯卡新成员——范冰冰！为小范童鞋骄傲，也为所有入选的中国影人骄傲！	 NEWS | 美国电影艺术与科学学院正式宣布2017年奥斯卡新成员名单，华语影人大放异彩，张曼玉、姜文、梁朝伟、刘嘉玲、范冰冰、甄子丹、温明娜、黄荣亮等入选演员部门，恭喜所有入选华语电影人！<br/><br/>恭喜@范冰冰@ 以中国女演员的身份再次受到国际影坛的瞩目，出道以来影视作品共计88部。近 ...
请爸爸对丕丕好一点！ @李晨@:父亲英明神武 <	谁说子桓不是孤的亲儿子？...@李晨@ 
右手边那个留给我！生日快乐！	感谢大家给我一个完美的生日！第一次设计的 纯洁的蓝天白云系列，已经全都卖空了，特别谢谢大家的支持！未来会更好！永远爱大家的包先生！ 
军师联盟，大爱，追剧中，不可自拔，我不抒发，我只安利！	军师联盟，大爱，追剧中，不可自拔！我不安利，我只抒发。 
 今年第一批44个孩子，已经有34个宝贝成功完成手术，正在恢复中，期待后面的手术都顺顺利利希望都是好消息！	 发布了头条文章：《【爱里的心2017】44名西藏患儿来沪手术： 半数患儿成功接受手术！》 < 
感谢20年有快乐陪伴，祝亲爱的快乐大本营20岁生日快乐，笑声不断，友情不散！	以快乐之名，与你相遇，<br/>我的青春有你，你的快乐有我，<br/>20岁，谢谢亲爱的你，<br/>陪我从过去到现在和未来<br/>前路可期，一直在一起！<br/><br/>@何炅@ @谢娜@ @李维嘉@ @吴昕@ @杜海涛@ 
胡小姐，卜先生，请问以后我是不是只能用这一个牌子的假睫毛了？ @胡議尹@:感谢有你 @卜柯文@:历经三年的开发周期，恭喜妞姐@胡議尹@ 领衔的[美集仕]假睫毛终于闪亮登场！	与@卜柯文@ 合作的假睫毛品牌Magius终于问世！作为范冰冰的御用化妆师，与曾为范冰冰、赵薇等明星打造过经典造型的卜柯文在研究了东西方女性的眼型与审美后，推出了符合各类人群的假睫毛，致力于为更多女性打造明星般的双眸！感谢姐@范冰冰@ 的鼎力相助，在戛纳等活动中冰冰都有佩戴magius的睫毛哦！ 
一年有365个日出，蔡老板送你365个祝福！祝《绝世高手》票房绕地球365圈！	电影中蔡老板魔性洗脑的“365个祝福”升级啦～这次和@郭采洁@ 重新演绎《新365个祝福》MV，感谢@赵英俊是潇洒哥@ 的改编，让春晚金曲一秒变身动人小情歌！< 
中国首部现代空军空战电影《空天猎》正式杀青！我们空军作战团队“霸天狼”不玩虚的，要的就是真·心跳！	由@李晨@ 执导并主演，@范冰冰@ @王千源@ @李佳航MVP@ @演员赵达@ @李晨浩Leon@ @郭洺宇@ @叶浏@ @陆思宇Kevin@  主演，@吴秀波@ 特别出演，@王学圻@ 友情出演，@吕建民@  担任总出品人的中国首部现代空军空战电影《空天猎》正式杀青！ 空中英豪“霸天狼”霸气登场  震撼来袭！ 
请问右边这位穿白衬衫的先森是叫齐天大圣吗？	 【黄金狗粮】喏，你们要的视频封面图，拿去吧@李晨@@范冰冰@ 
 开心的开始，顺利的治疗，健康的回家没有比这更好的了！我更高兴的是在阿里有一部分人开始有了对于身体健康的意识，观念的转变，我们继续加油吧[加油]	每一年@范冰冰@ 都会去医院看望来自阿里的孩子，给他们带去礼物、问候、安慰，以及面对手术的勇气和术后恢复的鼓励。今天，44个孩子刚到上海，冰冰就给了大家一个猝不及防的袭击，她带着朋友们空降医院，和孩子们拆礼物玩游戏。一个大大的开心作为开始，随后手术和恢复必然是顺利的！ 
